"date","geography","geography code","Rural Urban","Household Composition: count of Household; All households; measures: Value","Household Composition: No adults in employment in household; measures: Value","Household Composition: No adults in employment in household: With dependent children; measures: Value","Household Composition: No adults in employment in household: No dependent children; measures: Value","Household Composition: Dependent children in household: All ages; measures: Value","Household Composition: Dependent children in household: Age 0 to 4; measures: Value","Household Composition: One person in household with a long-term health problem or disability; measures: Value","Household Composition: One person in household with a long-term health problem or disability: With dependent children; measures: Value","Household Composition: One person in household with a long-term health problem or disability: No dependent children; measures: Value"
"2011","Darlington","E06000005","Total",46670,16868,2110,14758,13448,5313,12545,2113,10432
"2011","Darlington","E06000005","Urban (total)",41123,15129,2020,13109,11853,4750,11259,1898,9361
"2011","Darlington","E06000005","Urban major conurbation",0,0,0,0,0,0,0,0,0
"2011","Darlington","E06000005","Urban minor conurbation",0,0,0,0,0,0,0,0,0
"2011","Darlington","E06000005","Urban city and town",41123,15129,2020,13109,11853,4750,11259,1898,9361
"2011","Darlington","E06000005","Urban city and town in a sparse setting",0,0,0,0,0,0,0,0,0
"2011","Darlington","E06000005","Rural (total)",5547,1739,90,1649,1595,563,1286,215,1071
"2011","Darlington","E06000005","Rural town and fringe",3294,1032,55,977,1014,353,763,132,631
"2011","Darlington","E06000005","Rural town and fringe in a sparse setting",0,0,0,0,0,0,0,0,0
"2011","Darlington","E06000005","Rural village",1532,510,18,492,387,152,355,50,305
"2011","Darlington","E06000005","Rural village in a sparse setting",0,0,0,0,0,0,0,0,0
"2011","Darlington","E06000005","Rural hamlet and isolated dwellings",721,197,17,180,194,58,168,33,135
"2011","Darlington","E06000005","Rural hamlet and isolated dwellings in a sparse setting",0,0,0,0,0,0,0,0,0
"2011","County Durham","E06000047","Total",223803,87173,10216,76957,61108,23213,69048,11056,57992
"2011","County Durham","E06000047","Urban (total)",120268,47080,5797,41283,33501,12870,36912,6167,30745
"2011","County Durham","E06000047","Urban major conurbation",17422,6279,568,5711,4899,1740,4931,810,4121
"2011","County Durham","E06000047","Urban minor conurbation",0,0,0,0,0,0,0,0,0
"2011","County Durham","E06000047","Urban city and town",102846,40801,5229,35572,28602,11130,31981,5357,26624
"2011","County Durham","E06000047","Urban city and town in a sparse setting",0,0,0,0,0,0,0,0,0
"2011","County Durham","E06000047","Rural (total)",103535,40093,4419,35674,27607,10343,32136,4889,27247
"2011","County Durham","E06000047","Rural town and fringe",80160,32181,3741,28440,21677,8202,25687,3947,21740
"2011","County Durham","E06000047","Rural town and fringe in a sparse setting",126,68,2,66,23,8,48,2,46
"2011","County Durham","E06000047","Rural village",14804,5171,513,4658,3911,1428,4187,619,3568
"2011","County Durham","E06000047","Rural village in a sparse setting",1182,447,17,430,223,80,308,20,288
"2011","County Durham","E06000047","Rural hamlet and isolated dwellings",6425,1988,142,1846,1589,565,1712,274,1438
"2011","County Durham","E06000047","Rural hamlet and isolated dwellings in a sparse setting",838,238,4,234,184,60,194,27,167
"2011","Hartlepool","E06000001","Total",40434,17410,2769,14641,12091,4597,12388,2211,10177
"2011","Hartlepool","E06000001","Urban (total)",39054,16834,2737,14097,11747,4498,11951,2154,9797
"2011","Hartlepool","E06000001","Urban major conurbation",0,0,0,0,0,0,0,0,0
"2011","Hartlepool","E06000001","Urban minor conurbation",0,0,0,0,0,0,0,0,0
"2011","Hartlepool","E06000001","Urban city and town",39054,16834,2737,14097,11747,4498,11951,2154,9797
"2011","Hartlepool","E06000001","Urban city and town in a sparse setting",0,0,0,0,0,0,0,0,0
"2011","Hartlepool","E06000001","Rural (total)",1380,576,32,544,344,99,437,57,380
"2011","Hartlepool","E06000001","Rural town and fringe",392,232,11,221,68,23,177,17,160
"2011","Hartlepool","E06000001","Rural town and fringe in a sparse setting",0,0,0,0,0,0,0,0,0
"2011","Hartlepool","E06000001","Rural village",657,229,9,220,175,44,172,21,151
"2011","Hartlepool","E06000001","Rural village in a sparse setting",0,0,0,0,0,0,0,0,0
"2011","Hartlepool","E06000001","Rural hamlet and isolated dwellings",331,115,12,103,101,32,88,19,69
"2011","Hartlepool","E06000001","Rural hamlet and isolated dwellings in a sparse setting",0,0,0,0,0,0,0,0,0
"2011","Middlesbrough","E06000002","Total",57203,24362,4487,19875,17841,7353,17235,3360,13875
"2011","Middlesbrough","E06000002","Urban (total)",56870,24293,4471,19822,17701,7318,17172,3344,13828
"2011","Middlesbrough","E06000002","Urban major conurbation",0,0,0,0,0,0,0,0,0
"2011","Middlesbrough","E06000002","Urban minor conurbation",0,0,0,0,0,0,0,0,0
"2011","Middlesbrough","E06000002","Urban city and town",56870,24293,4471,19822,17701,7318,17172,3344,13828
"2011","Middlesbrough","E06000002","Urban city and town in a sparse setting",0,0,0,0,0,0,0,0,0
"2011","Middlesbrough","E06000002","Rural (total)",333,69,16,53,140,35,63,16,47
"2011","Middlesbrough","E06000002","Rural town and fringe",204,37,9,28,94,19,39,11,28
"2011","Middlesbrough","E06000002","Rural town and fringe in a sparse setting",0,0,0,0,0,0,0,0,0
"2011","Middlesbrough","E06000002","Rural village",129,32,7,25,46,16,24,5,19
"2011","Middlesbrough","E06000002","Rural village in a sparse setting",0,0,0,0,0,0,0,0,0
"2011","Middlesbrough","E06000002","Rural hamlet and isolated dwellings",0,0,0,0,0,0,0,0,0
"2011","Middlesbrough","E06000002","Rural hamlet and isolated dwellings in a sparse setting",0,0,0,0,0,0,0,0,0
"2011","Northumberland","E06000048","Total",138534,51811,4743,47068,36581,12859,38389,5850,32539
"2011","Northumberland","E06000048","Urban (total)",74511,28260,3123,25137,21014,7511,21092,3493,17599
"2011","Northumberland","E06000048","Urban major conurbation",11418,3710,329,3381,3311,1136,2917,544,2373
"2011","Northumberland","E06000048","Urban minor conurbation",0,0,0,0,0,0,0,0,0
"2011","Northumberland","E06000048","Urban city and town",57159,22346,2594,19752,16205,5774,16559,2722,13837
"2011","Northumberland","E06000048","Urban city and town in a sparse setting",5934,2204,200,2004,1498,601,1616,227,1389
"2011","Northumberland","E06000048","Rural (total)",64023,23551,1620,21931,15567,5348,17297,2357,14940
"2011","Northumberland","E06000048","Rural town and fringe",23674,9330,840,8490,6051,2251,6813,973,5840
"2011","Northumberland","E06000048","Rural town and fringe in a sparse setting",13133,5221,346,4875,3150,1115,3703,468,3235
"2011","Northumberland","E06000048","Rural village",5498,2005,135,1870,1389,460,1440,216,1224
"2011","Northumberland","E06000048","Rural village in a sparse setting",7724,3098,110,2988,1700,522,2148,261,1887
"2011","Northumberland","E06000048","Rural hamlet and isolated dwellings",6552,1733,93,1640,1705,505,1426,218,1208
"2011","Northumberland","E06000048","Rural hamlet and isolated dwellings in a sparse setting",7442,2164,96,2068,1572,495,1767,221,1546
"2011","Redcar and Cleveland","E06000003","Total",59605,25556,3306,22250,16808,6177,18026,2951,15075
"2011","Redcar and Cleveland","E06000003","Urban (total)",40079,17116,2388,14728,11654,4292,12146,2030,10116
"2011","Redcar and Cleveland","E06000003","Urban major conurbation",0,0,0,0,0,0,0,0,0
"2011","Redcar and Cleveland","E06000003","Urban minor conurbation",0,0,0,0,0,0,0,0,0
"2011","Redcar and Cleveland","E06000003","Urban city and town",40079,17116,2388,14728,11654,4292,12146,2030,10116
"2011","Redcar and Cleveland","E06000003","Urban city and town in a sparse setting",0,0,0,0,0,0,0,0,0
"2011","Redcar and Cleveland","E06000003","Rural (total)",19526,8440,918,7522,5154,1885,5880,921,4959
"2011","Redcar and Cleveland","E06000003","Rural town and fringe",17203,7465,828,6637,4639,1694,5160,814,4346
"2011","Redcar and Cleveland","E06000003","Rural town and fringe in a sparse setting",0,0,0,0,0,0,0,0,0
"2011","Redcar and Cleveland","E06000003","Rural village",1461,678,68,610,326,122,501,75,426
"2011","Redcar and Cleveland","E06000003","Rural village in a sparse setting",0,0,0,0,0,0,0,0,0
"2011","Redcar and Cleveland","E06000003","Rural hamlet and isolated dwellings",862,297,22,275,189,69,219,32,187
"2011","Redcar and Cleveland","E06000003","Rural hamlet and isolated dwellings in a sparse setting",0,0,0,0,0,0,0,0,0
"2011","Stockton-on-Tees","E06000004","Total",79159,28224,3957,24267,25067,9964,21247,4188,17059
"2011","Stockton-on-Tees","E06000004","Urban (total)",76154,27386,3910,23476,24147,9664,20583,4070,16513
"2011","Stockton-on-Tees","E06000004","Urban major conurbation",0,0,0,0,0,0,0,0,0
"2011","Stockton-on-Tees","E06000004","Urban minor conurbation",0,0,0,0,0,0,0,0,0
"2011","Stockton-on-Tees","E06000004","Urban city and town",76154,27386,3910,23476,24147,9664,20583,4070,16513
"2011","Stockton-on-Tees","E06000004","Urban city and town in a sparse setting",0,0,0,0,0,0,0,0,0
"2011","Stockton-on-Tees","E06000004","Rural (total)",3005,838,47,791,920,300,664,118,546
"2011","Stockton-on-Tees","E06000004","Rural town and fringe",155,38,2,36,61,24,36,8,28
"2011","Stockton-on-Tees","E06000004","Rural town and fringe in a sparse setting",0,0,0,0,0,0,0,0,0
"2011","Stockton-on-Tees","E06000004","Rural village",2377,681,42,639,716,241,525,91,434
"2011","Stockton-on-Tees","E06000004","Rural village in a sparse setting",0,0,0,0,0,0,0,0,0
"2011","Stockton-on-Tees","E06000004","Rural hamlet and isolated dwellings",473,119,3,116,143,35,103,19,84
"2011","Stockton-on-Tees","E06000004","Rural hamlet and isolated dwellings in a sparse setting",0,0,0,0,0,0,0,0,0
"2011","Gateshead","E08000020","Total",89154,34049,4337,29712,24071,9517,26680,4379,22301
"2011","Gateshead","E08000020","Urban (total)",82008,31263,4036,27227,22174,8845,24507,4042,20465
"2011","Gateshead","E08000020","Urban major conurbation",80709,30832,4005,26827,21830,8700,24125,3986,20139
"2011","Gateshead","E08000020","Urban minor conurbation",0,0,0,0,0,0,0,0,0
"2011","Gateshead","E08000020","Urban city and town",1299,431,31,400,344,145,382,56,326
"2011","Gateshead","E08000020","Urban city and town in a sparse setting",0,0,0,0,0,0,0,0,0
"2011","Gateshead","E08000020","Rural (total)",7146,2786,301,2485,1897,672,2173,337,1836
"2011","Gateshead","E08000020","Rural town and fringe",5791,2360,274,2086,1542,563,1830,286,1544
"2011","Gateshead","E08000020","Rural town and fringe in a sparse setting",0,0,0,0,0,0,0,0,0
"2011","Gateshead","E08000020","Rural village",691,265,16,249,174,57,184,22,162
"2011","Gateshead","E08000020","Rural village in a sparse setting",0,0,0,0,0,0,0,0,0
"2011","Gateshead","E08000020","Rural hamlet and isolated dwellings",664,161,11,150,181,52,159,29,130
"2011","Gateshead","E08000020","Rural hamlet and isolated dwellings in a sparse setting",0,0,0,0,0,0,0,0,0
"2011","Newcastle upon Tyne","E08000021","Total",117153,45670,6666,39004,30820,13008,32347,5604,26743
"2011","Newcastle upon Tyne","E08000021","Urban (total)",114611,44718,6554,38164,30117,12738,31640,5491,26149
"2011","Newcastle upon Tyne","E08000021","Urban major conurbation",114354,44613,6552,38061,30067,12719,31566,5482,26084
"2011","Newcastle upon Tyne","E08000021","Urban minor conurbation",0,0,0,0,0,0,0,0,0
"2011","Newcastle upon Tyne","E08000021","Urban city and town",257,105,2,103,50,19,74,9,65
"2011","Newcastle upon Tyne","E08000021","Urban city and town in a sparse setting",0,0,0,0,0,0,0,0,0
"2011","Newcastle upon Tyne","E08000021","Rural (total)",2542,952,112,840,703,270,707,113,594
"2011","Newcastle upon Tyne","E08000021","Rural town and fringe",1848,756,100,656,494,175,551,90,461
"2011","Newcastle upon Tyne","E08000021","Rural town and fringe in a sparse setting",0,0,0,0,0,0,0,0,0
"2011","Newcastle upon Tyne","E08000021","Rural village",694,196,12,184,209,95,156,23,133
"2011","Newcastle upon Tyne","E08000021","Rural village in a sparse setting",0,0,0,0,0,0,0,0,0
"2011","Newcastle upon Tyne","E08000021","Rural hamlet and isolated dwellings",0,0,0,0,0,0,0,0,0
"2011","Newcastle upon Tyne","E08000021","Rural hamlet and isolated dwellings in a sparse setting",0,0,0,0,0,0,0,0,0
"2011","North Tyneside","E08000022","Total",91295,33364,3736,29628,24976,9670,25468,3984,21484
"2011","North Tyneside","E08000022","Urban (total)",87306,31708,3616,28092,24043,9299,24261,3837,20424
"2011","North Tyneside","E08000022","Urban major conurbation",86552,31505,3575,27930,23798,9168,24097,3800,20297
"2011","North Tyneside","E08000022","Urban minor conurbation",0,0,0,0,0,0,0,0,0
"2011","North Tyneside","E08000022","Urban city and town",754,203,41,162,245,131,164,37,127
"2011","North Tyneside","E08000022","Urban city and town in a sparse setting",0,0,0,0,0,0,0,0,0
"2011","North Tyneside","E08000022","Rural (total)",3989,1656,120,1536,933,371,1207,147,1060
"2011","North Tyneside","E08000022","Rural town and fringe",3747,1576,96,1480,831,336,1134,120,1014
"2011","North Tyneside","E08000022","Rural town and fringe in a sparse setting",0,0,0,0,0,0,0,0,0
"2011","North Tyneside","E08000022","Rural village",114,40,12,28,49,16,37,12,25
"2011","North Tyneside","E08000022","Rural village in a sparse setting",0,0,0,0,0,0,0,0,0
"2011","North Tyneside","E08000022","Rural hamlet and isolated dwellings",128,40,12,28,53,19,36,15,21
"2011","North Tyneside","E08000022","Rural hamlet and isolated dwellings in a sparse setting",0,0,0,0,0,0,0,0,0
"2011","South Tyneside","E08000023","Total",67167,27965,3809,24156,18486,6782,21052,3439,17613
"2011","South Tyneside","E08000023","Urban (total)",66914,27878,3790,24088,18395,6749,20986,3421,17565
"2011","South Tyneside","E08000023","Urban major conurbation",64222,26694,3704,22990,17738,6522,20161,3314,16847
"2011","South Tyneside","E08000023","Urban minor conurbation",0,0,0,0,0,0,0,0,0
"2011","South Tyneside","E08000023","Urban city and town",2692,1184,86,1098,657,227,825,107,718
"2011","South Tyneside","E08000023","Urban city and town in a sparse setting",0,0,0,0,0,0,0,0,0
"2011","South Tyneside","E08000023","Rural (total)",253,87,19,68,91,33,66,18,48
"2011","South Tyneside","E08000023","Rural town and fringe",136,54,17,37,58,22,35,15,20
"2011","South Tyneside","E08000023","Rural town and fringe in a sparse setting",0,0,0,0,0,0,0,0,0
"2011","South Tyneside","E08000023","Rural village",0,0,0,0,0,0,0,0,0
"2011","South Tyneside","E08000023","Rural village in a sparse setting",0,0,0,0,0,0,0,0,0
"2011","South Tyneside","E08000023","Rural hamlet and isolated dwellings",117,33,2,31,33,11,31,3,28
"2011","South Tyneside","E08000023","Rural hamlet and isolated dwellings in a sparse setting",0,0,0,0,0,0,0,0,0
"2011","Sunderland","E08000024","Total",119758,47775,6158,41617,33634,12692,37272,6239,31033
"2011","Sunderland","E08000024","Urban (total)",119073,47505,6135,41370,33489,12639,37053,6215,30838
"2011","Sunderland","E08000024","Urban major conurbation",118686,47334,6095,41239,33359,12593,36930,6191,30739
"2011","Sunderland","E08000024","Urban minor conurbation",0,0,0,0,0,0,0,0,0
"2011","Sunderland","E08000024","Urban city and town",387,171,40,131,130,46,123,24,99
"2011","Sunderland","E08000024","Urban city and town in a sparse setting",0,0,0,0,0,0,0,0,0
"2011","Sunderland","E08000024","Rural (total)",685,270,23,247,145,53,219,24,195
"2011","Sunderland","E08000024","Rural town and fringe",559,224,19,205,121,46,174,22,152
"2011","Sunderland","E08000024","Rural town and fringe in a sparse setting",0,0,0,0,0,0,0,0,0
"2011","Sunderland","E08000024","Rural village",0,0,0,0,0,0,0,0,0
"2011","Sunderland","E08000024","Rural village in a sparse setting",0,0,0,0,0,0,0,0,0
"2011","Sunderland","E08000024","Rural hamlet and isolated dwellings",126,46,4,42,24,7,45,2,43
"2011","Sunderland","E08000024","Rural hamlet and isolated dwellings in a sparse setting",0,0,0,0,0,0,0,0,0
"2011","Blackburn with Darwen","E06000008","Total",57353,20597,3625,16972,20061,8596,17111,3981,13130
"2011","Blackburn with Darwen","E06000008","Urban (total)",54428,19807,3602,16205,19271,8363,16505,3884,12621
"2011","Blackburn with Darwen","E06000008","Urban major conurbation",0,0,0,0,0,0,0,0,0
"2011","Blackburn with Darwen","E06000008","Urban minor conurbation",0,0,0,0,0,0,0,0,0
"2011","Blackburn with Darwen","E06000008","Urban city and town",54428,19807,3602,16205,19271,8363,16505,3884,12621
"2011","Blackburn with Darwen","E06000008","Urban city and town in a sparse setting",0,0,0,0,0,0,0,0,0
"2011","Blackburn with Darwen","E06000008","Rural (total)",2925,790,23,767,790,233,606,97,509
"2011","Blackburn with Darwen","E06000008","Rural town and fringe",1139,356,5,351,281,85,267,35,232
"2011","Blackburn with Darwen","E06000008","Rural town and fringe in a sparse setting",0,0,0,0,0,0,0,0,0
"2011","Blackburn with Darwen","E06000008","Rural village",1020,245,12,233,276,96,207,42,165
"2011","Blackburn with Darwen","E06000008","Rural village in a sparse setting",0,0,0,0,0,0,0,0,0
"2011","Blackburn with Darwen","E06000008","Rural hamlet and isolated dwellings",766,189,6,183,233,52,132,20,112
"2011","Blackburn with Darwen","E06000008","Rural hamlet and isolated dwellings in a sparse setting",0,0,0,0,0,0,0,0,0
"2011","Blackpool","E06000009","Total",64367,27600,3596,24004,16906,6568,21615,3345,18270
"2011","Blackpool","E06000009","Urban (total)",64149,27547,3583,23964,16827,6536,21563,3329,18234
"2011","Blackpool","E06000009","Urban major conurbation",0,0,0,0,0,0,0,0,0
"2011","Blackpool","E06000009","Urban minor conurbation",0,0,0,0,0,0,0,0,0
"2011","Blackpool","E06000009","Urban city and town",64149,27547,3583,23964,16827,6536,21563,3329,18234
"2011","Blackpool","E06000009","Urban city and town in a sparse setting",0,0,0,0,0,0,0,0,0
"2011","Blackpool","E06000009","Rural (total)",218,53,13,40,79,32,52,16,36
"2011","Blackpool","E06000009","Rural town and fringe",218,53,13,40,79,32,52,16,36
"2011","Blackpool","E06000009","Rural town and fringe in a sparse setting",0,0,0,0,0,0,0,0,0
"2011","Blackpool","E06000009","Rural village",0,0,0,0,0,0,0,0,0
"2011","Blackpool","E06000009","Rural village in a sparse setting",0,0,0,0,0,0,0,0,0
"2011","Blackpool","E06000009","Rural hamlet and isolated dwellings",0,0,0,0,0,0,0,0,0
"2011","Blackpool","E06000009","Rural hamlet and isolated dwellings in a sparse setting",0,0,0,0,0,0,0,0,0
"2011","Cheshire East","E06000049","Total",159441,53053,4009,49044,44474,16133,39673,6045,33628
"2011","Cheshire East","E06000049","Urban (total)",130657,44059,3640,40419,36770,13720,33010,5129,27881
"2011","Cheshire East","E06000049","Urban major conurbation",19812,6566,352,6214,5539,1918,4790,727,4063
"2011","Cheshire East","E06000049","Urban minor conurbation",0,0,0,0,0,0,0,0,0
"2011","Cheshire East","E06000049","Urban city and town",110845,37493,3288,34205,31231,11802,28220,4402,23818
"2011","Cheshire East","E06000049","Urban city and town in a sparse setting",0,0,0,0,0,0,0,0,0
"2011","Cheshire East","E06000049","Rural (total)",28784,8994,369,8625,7704,2413,6663,916,5747
"2011","Cheshire East","E06000049","Rural town and fringe",8889,3077,102,2975,2364,746,2156,288,1868
"2011","Cheshire East","E06000049","Rural town and fringe in a sparse setting",0,0,0,0,0,0,0,0,0
"2011","Cheshire East","E06000049","Rural village",8890,2805,122,2683,2414,761,2068,280,1788
"2011","Cheshire East","E06000049","Rural village in a sparse setting",0,0,0,0,0,0,0,0,0
"2011","Cheshire East","E06000049","Rural hamlet and isolated dwellings",11005,3112,145,2967,2926,906,2439,348,2091
"2011","Cheshire East","E06000049","Rural hamlet and isolated dwellings in a sparse setting",0,0,0,0,0,0,0,0,0
"2011","Cheshire West and Chester","E06000050","Total",141442,48044,4328,43716,39085,14452,36889,5871,31018
"2011","Cheshire West and Chester","E06000050","Urban (total)",105014,35589,3770,31819,29502,11465,27865,4608,23257
"2011","Cheshire West and Chester","E06000050","Urban major conurbation",0,0,0,0,0,0,0,0,0
"2011","Cheshire West and Chester","E06000050","Urban minor conurbation",0,0,0,0,0,0,0,0,0
"2011","Cheshire West and Chester","E06000050","Urban city and town",105014,35589,3770,31819,29502,11465,27865,4608,23257
"2011","Cheshire West and Chester","E06000050","Urban city and town in a sparse setting",0,0,0,0,0,0,0,0,0
"2011","Cheshire West and Chester","E06000050","Rural (total)",36428,12455,558,11897,9583,2987,9024,1263,7761
"2011","Cheshire West and Chester","E06000050","Rural town and fringe",19427,7096,367,6729,5188,1721,5120,704,4416
"2011","Cheshire West and Chester","E06000050","Rural town and fringe in a sparse setting",0,0,0,0,0,0,0,0,0
"2011","Cheshire West and Chester","E06000050","Rural village",8530,2915,110,2805,2165,612,1989,273,1716
"2011","Cheshire West and Chester","E06000050","Rural village in a sparse setting",0,0,0,0,0,0,0,0,0
"2011","Cheshire West and Chester","E06000050","Rural hamlet and isolated dwellings",8471,2444,81,2363,2230,654,1915,286,1629
"2011","Cheshire West and Chester","E06000050","Rural hamlet and isolated dwellings in a sparse setting",0,0,0,0,0,0,0,0,0
"2011","Halton","E06000006","Total",53312,19340,3341,15999,16663,6724,15770,3053,12717
"2011","Halton","E06000006","Urban (total)",52004,18932,3323,15609,16308,6596,15411,2995,12416
"2011","Halton","E06000006","Urban major conurbation",0,0,0,0,0,0,0,0,0
"2011","Halton","E06000006","Urban minor conurbation",0,0,0,0,0,0,0,0,0
"2011","Halton","E06000006","Urban city and town",52004,18932,3323,15609,16308,6596,15411,2995,12416
"2011","Halton","E06000006","Urban city and town in a sparse setting",0,0,0,0,0,0,0,0,0
"2011","Halton","E06000006","Rural (total)",1308,408,18,390,355,128,359,58,301
"2011","Halton","E06000006","Rural town and fringe",906,296,15,281,240,74,262,45,217
"2011","Halton","E06000006","Rural town and fringe in a sparse setting",0,0,0,0,0,0,0,0,0
"2011","Halton","E06000006","Rural village",305,92,1,91,88,40,73,10,63
"2011","Halton","E06000006","Rural village in a sparse setting",0,0,0,0,0,0,0,0,0
"2011","Halton","E06000006","Rural hamlet and isolated dwellings",97,20,2,18,27,14,24,3,21
"2011","Halton","E06000006","Rural hamlet and isolated dwellings in a sparse setting",0,0,0,0,0,0,0,0,0
"2011","Warrington","E06000007","Total",85140,26676,2740,23936,26286,9927,21158,3661,17497
"2011","Warrington","E06000007","Urban (total)",75391,23564,2554,21010,23280,8967,18844,3269,15575
"2011","Warrington","E06000007","Urban major conurbation",0,0,0,0,0,0,0,0,0
"2011","Warrington","E06000007","Urban minor conurbation",0,0,0,0,0,0,0,0,0
"2011","Warrington","E06000007","Urban city and town",75391,23564,2554,21010,23280,8967,18844,3269,15575
"2011","Warrington","E06000007","Urban city and town in a sparse setting",0,0,0,0,0,0,0,0,0
"2011","Warrington","E06000007","Rural (total)",9749,3112,186,2926,3006,960,2314,392,1922
"2011","Warrington","E06000007","Rural town and fringe",5938,2095,123,1972,1806,570,1524,252,1272
"2011","Warrington","E06000007","Rural town and fringe in a sparse setting",0,0,0,0,0,0,0,0,0
"2011","Warrington","E06000007","Rural village",2147,588,44,544,676,234,462,75,387
"2011","Warrington","E06000007","Rural village in a sparse setting",0,0,0,0,0,0,0,0,0
"2011","Warrington","E06000007","Rural hamlet and isolated dwellings",1664,429,19,410,524,156,328,65,263
"2011","Warrington","E06000007","Rural hamlet and isolated dwellings in a sparse setting",0,0,0,0,0,0,0,0,0
"2011","Cumbria","E10000006","Total",222042,80655,6157,74498,55766,20196,61925,8837,53088
"2011","Cumbria","E10000006","Urban (total)",105159,38584,3774,34810,27551,10806,30124,4532,25592
"2011","Cumbria","E10000006","Urban major conurbation",0,0,0,0,0,0,0,0,0
"2011","Cumbria","E10000006","Urban minor conurbation",0,0,0,0,0,0,0,0,0
"2011","Cumbria","E10000006","Urban city and town",98523,36421,3664,32757,25906,10181,28384,4302,24082
"2011","Cumbria","E10000006","Urban city and town in a sparse setting",6636,2163,110,2053,1645,625,1740,230,1510
"2011","Cumbria","E10000006","Rural (total)",116883,42071,2383,39688,28215,9390,31801,4305,27496
"2011","Cumbria","E10000006","Rural town and fringe",45868,18039,1413,16626,11776,4141,13709,1972,11737
"2011","Cumbria","E10000006","Rural town and fringe in a sparse setting",13191,5162,266,4896,2860,994,3690,432,3258
"2011","Cumbria","E10000006","Rural village",20581,7048,299,6749,5082,1634,5211,702,4509
"2011","Cumbria","E10000006","Rural village in a sparse setting",16076,5528,191,5337,3688,1217,4056,503,3553
"2011","Cumbria","E10000006","Rural hamlet and isolated dwellings",11224,3305,116,3189,2636,774,2717,362,2355
"2011","Cumbria","E10000006","Rural hamlet and isolated dwellings in a sparse setting",9943,2989,98,2891,2173,630,2418,334,2084
"2011","Bolton","E08000001","Total",116371,42037,5779,36258,36232,14688,33358,6577,26781
"2011","Bolton","E08000001","Urban (total)",115280,41705,5762,35943,35980,14598,33083,6526,26557
"2011","Bolton","E08000001","Urban major conurbation",103309,37727,5468,32259,32592,13387,29895,5970,23925
"2011","Bolton","E08000001","Urban minor conurbation",0,0,0,0,0,0,0,0,0
"2011","Bolton","E08000001","Urban city and town",11971,3978,294,3684,3388,1211,3188,556,2632
"2011","Bolton","E08000001","Urban city and town in a sparse setting",0,0,0,0,0,0,0,0,0
"2011","Bolton","E08000001","Rural (total)",1091,332,17,315,252,90,275,51,224
"2011","Bolton","E08000001","Rural town and fringe",218,57,4,53,69,18,53,14,39
"2011","Bolton","E08000001","Rural town and fringe in a sparse setting",0,0,0,0,0,0,0,0,0
"2011","Bolton","E08000001","Rural village",213,84,1,83,46,20,46,9,37
"2011","Bolton","E08000001","Rural village in a sparse setting",0,0,0,0,0,0,0,0,0
"2011","Bolton","E08000001","Rural hamlet and isolated dwellings",660,191,12,179,137,52,176,28,148
"2011","Bolton","E08000001","Rural hamlet and isolated dwellings in a sparse setting",0,0,0,0,0,0,0,0,0
"2011","Bury","E08000002","Total",78113,25755,2951,22804,23819,9489,21224,3952,17272
"2011","Bury","E08000002","Urban (total)",76061,25215,2920,22295,23203,9275,20764,3879,16885
"2011","Bury","E08000002","Urban major conurbation",75716,25080,2911,22169,23116,9241,20666,3865,16801
"2011","Bury","E08000002","Urban minor conurbation",0,0,0,0,0,0,0,0,0
"2011","Bury","E08000002","Urban city and town",345,135,9,126,87,34,98,14,84
"2011","Bury","E08000002","Urban city and town in a sparse setting",0,0,0,0,0,0,0,0,0
"2011","Bury","E08000002","Rural (total)",2052,540,31,509,616,214,460,73,387
"2011","Bury","E08000002","Rural town and fringe",923,214,20,194,316,113,174,28,146
"2011","Bury","E08000002","Rural town and fringe in a sparse setting",0,0,0,0,0,0,0,0,0
"2011","Bury","E08000002","Rural village",841,247,8,239,221,79,221,38,183
"2011","Bury","E08000002","Rural village in a sparse setting",0,0,0,0,0,0,0,0,0
"2011","Bury","E08000002","Rural hamlet and isolated dwellings",288,79,3,76,79,22,65,7,58
"2011","Bury","E08000002","Rural hamlet and isolated dwellings in a sparse setting",0,0,0,0,0,0,0,0,0
"2011","Manchester","E08000003","Total",204969,73239,15731,57508,58346,28258,54956,11813,43143
"2011","Manchester","E08000003","Urban (total)",204927,73233,15730,57503,58336,28255,54945,11811,43134
"2011","Manchester","E08000003","Urban major conurbation",204927,73233,15730,57503,58336,28255,54945,11811,43134
"2011","Manchester","E08000003","Urban minor conurbation",0,0,0,0,0,0,0,0,0
"2011","Manchester","E08000003","Urban city and town",0,0,0,0,0,0,0,0,0
"2011","Manchester","E08000003","Urban city and town in a sparse setting",0,0,0,0,0,0,0,0,0
"2011","Manchester","E08000003","Rural (total)",42,6,1,5,10,3,11,2,9
"2011","Manchester","E08000003","Rural town and fringe",0,0,0,0,0,0,0,0,0
"2011","Manchester","E08000003","Rural town and fringe in a sparse setting",0,0,0,0,0,0,0,0,0
"2011","Manchester","E08000003","Rural village",0,0,0,0,0,0,0,0,0
"2011","Manchester","E08000003","Rural village in a sparse setting",0,0,0,0,0,0,0,0,0
"2011","Manchester","E08000003","Rural hamlet and isolated dwellings",42,6,1,5,10,3,11,2,9
"2011","Manchester","E08000003","Rural hamlet and isolated dwellings in a sparse setting",0,0,0,0,0,0,0,0,0
"2011","Oldham","E08000004","Total",89703,32290,5347,26943,30353,12759,26574,5628,20946
"2011","Oldham","E08000004","Urban (total)",88628,32029,5337,26692,30050,12663,26326,5580,20746
"2011","Oldham","E08000004","Urban major conurbation",85521,31077,5299,25778,29151,12380,25572,5451,20121
"2011","Oldham","E08000004","Urban minor conurbation",0,0,0,0,0,0,0,0,0
"2011","Oldham","E08000004","Urban city and town",3107,952,38,914,899,283,754,129,625
"2011","Oldham","E08000004","Urban city and town in a sparse setting",0,0,0,0,0,0,0,0,0
"2011","Oldham","E08000004","Rural (total)",1075,261,10,251,303,96,248,48,200
"2011","Oldham","E08000004","Rural town and fringe",141,39,2,37,36,11,38,7,31
"2011","Oldham","E08000004","Rural town and fringe in a sparse setting",0,0,0,0,0,0,0,0,0
"2011","Oldham","E08000004","Rural village",129,33,3,30,40,17,33,8,25
"2011","Oldham","E08000004","Rural village in a sparse setting",0,0,0,0,0,0,0,0,0
"2011","Oldham","E08000004","Rural hamlet and isolated dwellings",805,189,5,184,227,68,177,33,144
"2011","Oldham","E08000004","Rural hamlet and isolated dwellings in a sparse setting",0,0,0,0,0,0,0,0,0
"2011","Rochdale","E08000005","Total",87552,32726,5311,27415,28237,11515,26609,5578,21031
"2011","Rochdale","E08000005","Urban (total)",86457,32426,5300,27126,28007,11444,26344,5539,20805
"2011","Rochdale","E08000005","Urban major conurbation",85143,32070,5252,26818,27591,11298,26034,5458,20576
"2011","Rochdale","E08000005","Urban minor conurbation",0,0,0,0,0,0,0,0,0
"2011","Rochdale","E08000005","Urban city and town",1314,356,48,308,416,146,310,81,229
"2011","Rochdale","E08000005","Urban city and town in a sparse setting",0,0,0,0,0,0,0,0,0
"2011","Rochdale","E08000005","Rural (total)",1095,300,11,289,230,71,265,39,226
"2011","Rochdale","E08000005","Rural town and fringe",213,72,0,72,39,11,66,11,55
"2011","Rochdale","E08000005","Rural town and fringe in a sparse setting",0,0,0,0,0,0,0,0,0
"2011","Rochdale","E08000005","Rural village",245,75,1,74,43,15,66,5,61
"2011","Rochdale","E08000005","Rural village in a sparse setting",0,0,0,0,0,0,0,0,0
"2011","Rochdale","E08000005","Rural hamlet and isolated dwellings",637,153,10,143,148,45,133,23,110
"2011","Rochdale","E08000005","Rural hamlet and isolated dwellings in a sparse setting",0,0,0,0,0,0,0,0,0
"2011","Salford","E08000006","Total",103556,38330,6287,32043,28742,12753,30128,5294,24834
"2011","Salford","E08000006","Urban (total)",103441,38295,6286,32009,28716,12746,30097,5291,24806
"2011","Salford","E08000006","Urban major conurbation",103441,38295,6286,32009,28716,12746,30097,5291,24806
"2011","Salford","E08000006","Urban minor conurbation",0,0,0,0,0,0,0,0,0
"2011","Salford","E08000006","Urban city and town",0,0,0,0,0,0,0,0,0
"2011","Salford","E08000006","Urban city and town in a sparse setting",0,0,0,0,0,0,0,0,0
"2011","Salford","E08000006","Rural (total)",115,35,1,34,26,7,31,3,28
"2011","Salford","E08000006","Rural town and fringe",0,0,0,0,0,0,0,0,0
"2011","Salford","E08000006","Rural town and fringe in a sparse setting",0,0,0,0,0,0,0,0,0
"2011","Salford","E08000006","Rural village",0,0,0,0,0,0,0,0,0
"2011","Salford","E08000006","Rural village in a sparse setting",0,0,0,0,0,0,0,0,0
"2011","Salford","E08000006","Rural hamlet and isolated dwellings",115,35,1,34,26,7,31,3,28
"2011","Salford","E08000006","Rural hamlet and isolated dwellings in a sparse setting",0,0,0,0,0,0,0,0,0
"2011","Stockport","E08000007","Total",121979,41475,4098,37377,35730,13887,32493,5711,26782
"2011","Stockport","E08000007","Urban (total)",121448,41327,4095,37232,35607,13850,32396,5696,26700
"2011","Stockport","E08000007","Urban major conurbation",118229,40032,4056,35976,34855,13601,31554,5597,25957
"2011","Stockport","E08000007","Urban minor conurbation",0,0,0,0,0,0,0,0,0
"2011","Stockport","E08000007","Urban city and town",3219,1295,39,1256,752,249,842,99,743
"2011","Stockport","E08000007","Urban city and town in a sparse setting",0,0,0,0,0,0,0,0,0
"2011","Stockport","E08000007","Rural (total)",531,148,3,145,123,37,97,15,82
"2011","Stockport","E08000007","Rural town and fringe",0,0,0,0,0,0,0,0,0
"2011","Stockport","E08000007","Rural town and fringe in a sparse setting",0,0,0,0,0,0,0,0,0
"2011","Stockport","E08000007","Rural village",0,0,0,0,0,0,0,0,0
"2011","Stockport","E08000007","Rural village in a sparse setting",0,0,0,0,0,0,0,0,0
"2011","Stockport","E08000007","Rural hamlet and isolated dwellings",531,148,3,145,123,37,97,15,82
"2011","Stockport","E08000007","Rural hamlet and isolated dwellings in a sparse setting",0,0,0,0,0,0,0,0,0
"2011","Tameside","E08000008","Total",94953,33846,4796,29050,28569,11631,27984,5166,22818
"2011","Tameside","E08000008","Urban (total)",94698,33787,4792,28995,28494,11604,27935,5157,22778
"2011","Tameside","E08000008","Urban major conurbation",93848,33586,4781,28805,28264,11523,27760,5122,22638
"2011","Tameside","E08000008","Urban minor conurbation",0,0,0,0,0,0,0,0,0
"2011","Tameside","E08000008","Urban city and town",850,201,11,190,230,81,175,35,140
"2011","Tameside","E08000008","Urban city and town in a sparse setting",0,0,0,0,0,0,0,0,0
"2011","Tameside","E08000008","Rural (total)",255,59,4,55,75,27,49,9,40
"2011","Tameside","E08000008","Rural town and fringe",0,0,0,0,0,0,0,0,0
"2011","Tameside","E08000008","Rural town and fringe in a sparse setting",0,0,0,0,0,0,0,0,0
"2011","Tameside","E08000008","Rural village",0,0,0,0,0,0,0,0,0
"2011","Tameside","E08000008","Rural village in a sparse setting",0,0,0,0,0,0,0,0,0
"2011","Tameside","E08000008","Rural hamlet and isolated dwellings",255,59,4,55,75,27,49,9,40
"2011","Tameside","E08000008","Rural hamlet and isolated dwellings in a sparse setting",0,0,0,0,0,0,0,0,0
"2011","Trafford","E08000009","Total",94484,29867,3199,26668,29754,11765,24101,4330,19771
"2011","Trafford","E08000009","Urban (total)",94143,29765,3192,26573,29658,11732,24028,4321,19707
"2011","Trafford","E08000009","Urban major conurbation",92458,29248,3163,26085,29084,11541,23656,4258,19398
"2011","Trafford","E08000009","Urban minor conurbation",0,0,0,0,0,0,0,0,0
"2011","Trafford","E08000009","Urban city and town",1685,517,29,488,574,191,372,63,309
"2011","Trafford","E08000009","Urban city and town in a sparse setting",0,0,0,0,0,0,0,0,0
"2011","Trafford","E08000009","Rural (total)",341,102,7,95,96,33,73,9,64
"2011","Trafford","E08000009","Rural town and fringe",0,0,0,0,0,0,0,0,0
"2011","Trafford","E08000009","Rural town and fringe in a sparse setting",0,0,0,0,0,0,0,0,0
"2011","Trafford","E08000009","Rural village",250,72,7,65,67,21,56,5,51
"2011","Trafford","E08000009","Rural village in a sparse setting",0,0,0,0,0,0,0,0,0
"2011","Trafford","E08000009","Rural hamlet and isolated dwellings",91,30,0,30,29,12,17,4,13
"2011","Trafford","E08000009","Rural hamlet and isolated dwellings in a sparse setting",0,0,0,0,0,0,0,0,0
"2011","Wigan","E08000010","Total",136386,48281,6291,41990,41265,16083,39569,7137,32432
"2011","Wigan","E08000010","Urban (total)",131352,46265,6024,40241,39817,15537,37965,6846,31119
"2011","Wigan","E08000010","Urban major conurbation",128993,45526,5981,39545,39181,15320,37426,6760,30666
"2011","Wigan","E08000010","Urban minor conurbation",0,0,0,0,0,0,0,0,0
"2011","Wigan","E08000010","Urban city and town",2359,739,43,696,636,217,539,86,453
"2011","Wigan","E08000010","Urban city and town in a sparse setting",0,0,0,0,0,0,0,0,0
"2011","Wigan","E08000010","Rural (total)",5034,2016,267,1749,1448,546,1604,291,1313
"2011","Wigan","E08000010","Rural town and fringe",3589,1559,206,1353,1007,396,1196,205,991
"2011","Wigan","E08000010","Rural town and fringe in a sparse setting",0,0,0,0,0,0,0,0,0
"2011","Wigan","E08000010","Rural village",938,333,48,285,258,85,275,59,216
"2011","Wigan","E08000010","Rural village in a sparse setting",0,0,0,0,0,0,0,0,0
"2011","Wigan","E08000010","Rural hamlet and isolated dwellings",507,124,13,111,183,65,133,27,106
"2011","Wigan","E08000010","Rural hamlet and isolated dwellings in a sparse setting",0,0,0,0,0,0,0,0,0
"2011","Lancashire","E10000017","Total",496299,176807,18212,158595,140037,54510,138733,22940,115793
"2011","Lancashire","E10000017","Urban (total)",397852,144504,16563,127941,113839,45825,113452,19230,94222
"2011","Lancashire","E10000017","Urban major conurbation",17184,6297,1303,4994,5935,2319,4960,1064,3896
"2011","Lancashire","E10000017","Urban minor conurbation",0,0,0,0,0,0,0,0,0
"2011","Lancashire","E10000017","Urban city and town",380668,138207,15260,122947,107904,43506,108492,18166,90326
"2011","Lancashire","E10000017","Urban city and town in a sparse setting",0,0,0,0,0,0,0,0,0
"2011","Lancashire","E10000017","Rural (total)",98447,32303,1649,30654,26198,8685,25281,3710,21571
"2011","Lancashire","E10000017","Rural town and fringe",55567,19387,1127,18260,14876,5177,14926,2172,12754
"2011","Lancashire","E10000017","Rural town and fringe in a sparse setting",0,0,0,0,0,0,0,0,0
"2011","Lancashire","E10000017","Rural village",22590,7394,311,7083,5919,1918,5736,815,4921
"2011","Lancashire","E10000017","Rural village in a sparse setting",0,0,0,0,0,0,0,0,0
"2011","Lancashire","E10000017","Rural hamlet and isolated dwellings",20106,5464,211,5253,5360,1579,4580,718,3862
"2011","Lancashire","E10000017","Rural hamlet and isolated dwellings in a sparse setting",184,58,0,58,43,11,39,5,34
"2011","Knowsley","E08000011","Total",61323,25248,4644,20604,19611,7460,20502,4101,16401
"2011","Knowsley","E08000011","Urban (total)",60884,25035,4612,20423,19496,7414,20344,4073,16271
"2011","Knowsley","E08000011","Urban major conurbation",59042,24285,4562,19723,19028,7240,19753,3982,15771
"2011","Knowsley","E08000011","Urban minor conurbation",0,0,0,0,0,0,0,0,0
"2011","Knowsley","E08000011","Urban city and town",1842,750,50,700,468,174,591,91,500
"2011","Knowsley","E08000011","Urban city and town in a sparse setting",0,0,0,0,0,0,0,0,0
"2011","Knowsley","E08000011","Rural (total)",439,213,32,181,115,46,158,28,130
"2011","Knowsley","E08000011","Rural town and fringe",109,61,25,36,56,27,43,18,25
"2011","Knowsley","E08000011","Rural town and fringe in a sparse setting",0,0,0,0,0,0,0,0,0
"2011","Knowsley","E08000011","Rural village",0,0,0,0,0,0,0,0,0
"2011","Knowsley","E08000011","Rural village in a sparse setting",0,0,0,0,0,0,0,0,0
"2011","Knowsley","E08000011","Rural hamlet and isolated dwellings",330,152,7,145,59,19,115,10,105
"2011","Knowsley","E08000011","Rural hamlet and isolated dwellings in a sparse setting",0,0,0,0,0,0,0,0,0
"2011","Liverpool","E08000012","Total",206515,85807,13719,72088,53671,21051,64036,11155,52881
"2011","Liverpool","E08000012","Urban (total)",206515,85807,13719,72088,53671,21051,64036,11155,52881
"2011","Liverpool","E08000012","Urban major conurbation",206515,85807,13719,72088,53671,21051,64036,11155,52881
"2011","Liverpool","E08000012","Urban minor conurbation",0,0,0,0,0,0,0,0,0
"2011","Liverpool","E08000012","Urban city and town",0,0,0,0,0,0,0,0,0
"2011","Liverpool","E08000012","Urban city and town in a sparse setting",0,0,0,0,0,0,0,0,0
"2011","Liverpool","E08000012","Rural (total)",0,0,0,0,0,0,0,0,0
"2011","Liverpool","E08000012","Rural town and fringe",0,0,0,0,0,0,0,0,0
"2011","Liverpool","E08000012","Rural town and fringe in a sparse setting",0,0,0,0,0,0,0,0,0
"2011","Liverpool","E08000012","Rural village",0,0,0,0,0,0,0,0,0
"2011","Liverpool","E08000012","Rural village in a sparse setting",0,0,0,0,0,0,0,0,0
"2011","Liverpool","E08000012","Rural hamlet and isolated dwellings",0,0,0,0,0,0,0,0,0
"2011","Liverpool","E08000012","Rural hamlet and isolated dwellings in a sparse setting",0,0,0,0,0,0,0,0,0
"2011","Sefton","E08000014","Total",117930,46887,4809,42078,32223,11658,36410,5909,30501
"2011","Sefton","E08000014","Urban (total)",116265,46323,4781,41542,31827,11537,35970,5846,30124
"2011","Sefton","E08000014","Urban major conurbation",66189,26416,3407,23009,18982,6957,21285,3715,17570
"2011","Sefton","E08000014","Urban minor conurbation",0,0,0,0,0,0,0,0,0
"2011","Sefton","E08000014","Urban city and town",50076,19907,1374,18533,12845,4580,14685,2131,12554
"2011","Sefton","E08000014","Urban city and town in a sparse setting",0,0,0,0,0,0,0,0,0
"2011","Sefton","E08000014","Rural (total)",1665,564,28,536,396,121,440,63,377
"2011","Sefton","E08000014","Rural town and fringe",892,311,9,302,191,51,223,27,196
"2011","Sefton","E08000014","Rural town and fringe in a sparse setting",0,0,0,0,0,0,0,0,0
"2011","Sefton","E08000014","Rural village",438,145,10,135,120,45,108,19,89
"2011","Sefton","E08000014","Rural village in a sparse setting",0,0,0,0,0,0,0,0,0
"2011","Sefton","E08000014","Rural hamlet and isolated dwellings",335,108,9,99,85,25,109,17,92
"2011","Sefton","E08000014","Rural hamlet and isolated dwellings in a sparse setting",0,0,0,0,0,0,0,0,0
"2011","St. Helens","E08000013","Total",75736,29519,4158,25361,22029,8317,22966,3934,19032
"2011","St. Helens","E08000013","Urban (total)",71645,28011,4075,23936,20982,7978,21833,3761,18072
"2011","St. Helens","E08000013","Urban major conurbation",68521,26757,4027,22730,20229,7753,20943,3636,17307
"2011","St. Helens","E08000013","Urban minor conurbation",0,0,0,0,0,0,0,0,0
"2011","St. Helens","E08000013","Urban city and town",3124,1254,48,1206,753,225,890,125,765
"2011","St. Helens","E08000013","Urban city and town in a sparse setting",0,0,0,0,0,0,0,0,0
"2011","St. Helens","E08000013","Rural (total)",4091,1508,83,1425,1047,339,1133,173,960
"2011","St. Helens","E08000013","Rural town and fringe",3422,1285,72,1213,887,287,920,145,775
"2011","St. Helens","E08000013","Rural town and fringe in a sparse setting",0,0,0,0,0,0,0,0,0
"2011","St. Helens","E08000013","Rural village",148,59,1,58,32,13,48,6,42
"2011","St. Helens","E08000013","Rural village in a sparse setting",0,0,0,0,0,0,0,0,0
"2011","St. Helens","E08000013","Rural hamlet and isolated dwellings",521,164,10,154,128,39,165,22,143
"2011","St. Helens","E08000013","Rural hamlet and isolated dwellings in a sparse setting",0,0,0,0,0,0,0,0,0
"2011","Wirral","E08000015","Total",140583,56519,7259,49260,39642,14801,43678,7367,36311
"2011","Wirral","E08000015","Urban (total)",138992,55948,7237,48711,39300,14684,43270,7317,35953
"2011","Wirral","E08000015","Urban major conurbation",137969,55553,7230,48323,39058,14619,43049,7280,35769
"2011","Wirral","E08000015","Urban minor conurbation",0,0,0,0,0,0,0,0,0
"2011","Wirral","E08000015","Urban city and town",1023,395,7,388,242,65,221,37,184
"2011","Wirral","E08000015","Urban city and town in a sparse setting",0,0,0,0,0,0,0,0,0
"2011","Wirral","E08000015","Rural (total)",1591,571,22,549,342,117,408,50,358
"2011","Wirral","E08000015","Rural town and fringe",436,198,6,192,47,14,134,10,124
"2011","Wirral","E08000015","Rural town and fringe in a sparse setting",0,0,0,0,0,0,0,0,0
"2011","Wirral","E08000015","Rural village",451,171,7,164,100,30,117,12,105
"2011","Wirral","E08000015","Rural village in a sparse setting",0,0,0,0,0,0,0,0,0
"2011","Wirral","E08000015","Rural hamlet and isolated dwellings",704,202,9,193,195,73,157,28,129
"2011","Wirral","E08000015","Rural hamlet and isolated dwellings in a sparse setting",0,0,0,0,0,0,0,0,0
"2011","East Riding of Yorkshire","E06000011","Total",143032,51253,3458,47795,37852,13119,36708,5290,31418
"2011","East Riding of Yorkshire","E06000011","Urban (total)",81285,30395,2279,28116,21782,7819,21166,3064,18102
"2011","East Riding of Yorkshire","E06000011","Urban major conurbation",0,0,0,0,0,0,0,0,0
"2011","East Riding of Yorkshire","E06000011","Urban minor conurbation",0,0,0,0,0,0,0,0,0
"2011","East Riding of Yorkshire","E06000011","Urban city and town",81285,30395,2279,28116,21782,7819,21166,3064,18102
"2011","East Riding of Yorkshire","E06000011","Urban city and town in a sparse setting",0,0,0,0,0,0,0,0,0
"2011","East Riding of Yorkshire","E06000011","Rural (total)",61747,20858,1179,19679,16070,5300,15542,2226,13316
"2011","East Riding of Yorkshire","E06000011","Rural town and fringe",34944,12639,738,11901,9200,3127,9016,1245,7771
"2011","East Riding of Yorkshire","E06000011","Rural town and fringe in a sparse setting",0,0,0,0,0,0,0,0,0
"2011","East Riding of Yorkshire","E06000011","Rural village",20834,6639,360,6279,5341,1709,5164,749,4415
"2011","East Riding of Yorkshire","E06000011","Rural village in a sparse setting",0,0,0,0,0,0,0,0,0
"2011","East Riding of Yorkshire","E06000011","Rural hamlet and isolated dwellings",5969,1580,81,1499,1529,464,1362,232,1130
"2011","East Riding of Yorkshire","E06000011","Rural hamlet and isolated dwellings in a sparse setting",0,0,0,0,0,0,0,0,0
"2011","Kingston upon Hull, City of","E06000010","Total",112596,44205,7757,36448,32025,13913,30984,5306,25678
"2011","Kingston upon Hull, City of","E06000010","Urban (total)",112596,44205,7757,36448,32025,13913,30984,5306,25678
"2011","Kingston upon Hull, City of","E06000010","Urban major conurbation",0,0,0,0,0,0,0,0,0
"2011","Kingston upon Hull, City of","E06000010","Urban minor conurbation",0,0,0,0,0,0,0,0,0
"2011","Kingston upon Hull, City of","E06000010","Urban city and town",112596,44205,7757,36448,32025,13913,30984,5306,25678
"2011","Kingston upon Hull, City of","E06000010","Urban city and town in a sparse setting",0,0,0,0,0,0,0,0,0
"2011","Kingston upon Hull, City of","E06000010","Rural (total)",0,0,0,0,0,0,0,0,0
"2011","Kingston upon Hull, City of","E06000010","Rural town and fringe",0,0,0,0,0,0,0,0,0
"2011","Kingston upon Hull, City of","E06000010","Rural town and fringe in a sparse setting",0,0,0,0,0,0,0,0,0
"2011","Kingston upon Hull, City of","E06000010","Rural village",0,0,0,0,0,0,0,0,0
"2011","Kingston upon Hull, City of","E06000010","Rural village in a sparse setting",0,0,0,0,0,0,0,0,0
"2011","Kingston upon Hull, City of","E06000010","Rural hamlet and isolated dwellings",0,0,0,0,0,0,0,0,0
"2011","Kingston upon Hull, City of","E06000010","Rural hamlet and isolated dwellings in a sparse setting",0,0,0,0,0,0,0,0,0
"2011","North East Lincolnshire","E06000012","Total",69707,26937,4064,22873,19886,7884,18708,3006,15702
"2011","North East Lincolnshire","E06000012","Urban (total)",63246,24869,3978,20891,18023,7309,17232,2788,14444
"2011","North East Lincolnshire","E06000012","Urban major conurbation",0,0,0,0,0,0,0,0,0
"2011","North East Lincolnshire","E06000012","Urban minor conurbation",0,0,0,0,0,0,0,0,0
"2011","North East Lincolnshire","E06000012","Urban city and town",63246,24869,3978,20891,18023,7309,17232,2788,14444
"2011","North East Lincolnshire","E06000012","Urban city and town in a sparse setting",0,0,0,0,0,0,0,0,0
"2011","North East Lincolnshire","E06000012","Rural (total)",6461,2068,86,1982,1863,575,1476,218,1258
"2011","North East Lincolnshire","E06000012","Rural town and fringe",4522,1378,57,1321,1426,450,1022,155,867
"2011","North East Lincolnshire","E06000012","Rural town and fringe in a sparse setting",0,0,0,0,0,0,0,0,0
"2011","North East Lincolnshire","E06000012","Rural village",1296,463,18,445,277,80,301,42,259
"2011","North East Lincolnshire","E06000012","Rural village in a sparse setting",0,0,0,0,0,0,0,0,0
"2011","North East Lincolnshire","E06000012","Rural hamlet and isolated dwellings",643,227,11,216,160,45,153,21,132
"2011","North East Lincolnshire","E06000012","Rural hamlet and isolated dwellings in a sparse setting",0,0,0,0,0,0,0,0,0
"2011","North Lincolnshire","E06000013","Total",70684,24612,2761,21851,20401,8093,18899,3159,15740
"2011","North Lincolnshire","E06000013","Urban (total)",38798,13907,1967,11940,11675,5042,10560,1860,8700
"2011","North Lincolnshire","E06000013","Urban major conurbation",0,0,0,0,0,0,0,0,0
"2011","North Lincolnshire","E06000013","Urban minor conurbation",0,0,0,0,0,0,0,0,0
"2011","North Lincolnshire","E06000013","Urban city and town",38798,13907,1967,11940,11675,5042,10560,1860,8700
"2011","North Lincolnshire","E06000013","Urban city and town in a sparse setting",0,0,0,0,0,0,0,0,0
"2011","North Lincolnshire","E06000013","Rural (total)",31886,10705,794,9911,8726,3051,8339,1299,7040
"2011","North Lincolnshire","E06000013","Rural town and fringe",20641,7175,563,6612,5796,2079,5440,846,4594
"2011","North Lincolnshire","E06000013","Rural town and fringe in a sparse setting",0,0,0,0,0,0,0,0,0
"2011","North Lincolnshire","E06000013","Rural village",8311,2699,178,2521,2140,708,2173,334,1839
"2011","North Lincolnshire","E06000013","Rural village in a sparse setting",0,0,0,0,0,0,0,0,0
"2011","North Lincolnshire","E06000013","Rural hamlet and isolated dwellings",2934,831,53,778,790,264,726,119,607
"2011","North Lincolnshire","E06000013","Rural hamlet and isolated dwellings in a sparse setting",0,0,0,0,0,0,0,0,0
"2011","York","E06000014","Total",83552,26838,2034,24804,21317,8554,19220,2712,16508
"2011","York","E06000014","Urban (total)",70553,22543,1889,20654,17491,7292,16323,2261,14062
"2011","York","E06000014","Urban major conurbation",0,0,0,0,0,0,0,0,0
"2011","York","E06000014","Urban minor conurbation",0,0,0,0,0,0,0,0,0
"2011","York","E06000014","Urban city and town",70553,22543,1889,20654,17491,7292,16323,2261,14062
"2011","York","E06000014","Urban city and town in a sparse setting",0,0,0,0,0,0,0,0,0
"2011","York","E06000014","Rural (total)",12999,4295,145,4150,3826,1262,2897,451,2446
"2011","York","E06000014","Rural town and fringe",9631,3288,97,3191,2908,990,2160,342,1818
"2011","York","E06000014","Rural town and fringe in a sparse setting",0,0,0,0,0,0,0,0,0
"2011","York","E06000014","Rural village",2424,754,33,721,661,191,519,72,447
"2011","York","E06000014","Rural village in a sparse setting",0,0,0,0,0,0,0,0,0
"2011","York","E06000014","Rural hamlet and isolated dwellings",944,253,15,238,257,81,218,37,181
"2011","York","E06000014","Rural hamlet and isolated dwellings in a sparse setting",0,0,0,0,0,0,0,0,0
"2011","North Yorkshire","E10000023","Total",256594,86348,5528,80820,67943,24501,64282,9181,55101
"2011","North Yorkshire","E10000023","Urban (total)",117010,40411,3251,37160,31914,12460,30165,4388,25777
"2011","North Yorkshire","E10000023","Urban major conurbation",140,67,0,67,28,12,27,3,24
"2011","North Yorkshire","E10000023","Urban minor conurbation",0,0,0,0,0,0,0,0,0
"2011","North Yorkshire","E10000023","Urban city and town",110773,37853,3058,34795,30515,11933,28310,4188,24122
"2011","North Yorkshire","E10000023","Urban city and town in a sparse setting",6097,2491,193,2298,1371,515,1828,197,1631
"2011","North Yorkshire","E10000023","Rural (total)",139584,45937,2277,43660,36029,12041,34117,4793,29324
"2011","North Yorkshire","E10000023","Rural town and fringe",43678,15788,956,14832,11464,3995,11497,1639,9858
"2011","North Yorkshire","E10000023","Rural town and fringe in a sparse setting",15036,6087,272,5815,3287,1089,4172,445,3727
"2011","North Yorkshire","E10000023","Rural village",42074,12714,612,12102,11746,3943,9715,1505,8210
"2011","North Yorkshire","E10000023","Rural village in a sparse setting",10366,3628,130,3498,2179,663,2613,302,2311
"2011","North Yorkshire","E10000023","Rural hamlet and isolated dwellings",22206,5923,237,5686,5957,1886,4693,716,3977
"2011","North Yorkshire","E10000023","Rural hamlet and isolated dwellings in a sparse setting",6224,1797,70,1727,1396,465,1427,186,1241
"2011","Barnsley","E08000016","Total",100734,38675,5303,33372,29335,11191,30992,5450,25542
"2011","Barnsley","E08000016","Urban (total)",90501,35028,4915,30113,26373,10144,28112,4957,23155
"2011","Barnsley","E08000016","Urban major conurbation",0,0,0,0,0,0,0,0,0
"2011","Barnsley","E08000016","Urban minor conurbation",80898,31717,4641,27076,23580,9146,25460,4534,20926
"2011","Barnsley","E08000016","Urban city and town",9603,3311,274,3037,2793,998,2652,423,2229
"2011","Barnsley","E08000016","Urban city and town in a sparse setting",0,0,0,0,0,0,0,0,0
"2011","Barnsley","E08000016","Rural (total)",10233,3647,388,3259,2962,1047,2880,493,2387
"2011","Barnsley","E08000016","Rural town and fringe",6067,2285,326,1959,1922,696,1828,353,1475
"2011","Barnsley","E08000016","Rural town and fringe in a sparse setting",0,0,0,0,0,0,0,0,0
"2011","Barnsley","E08000016","Rural village",2573,898,44,854,648,214,644,86,558
"2011","Barnsley","E08000016","Rural village in a sparse setting",0,0,0,0,0,0,0,0,0
"2011","Barnsley","E08000016","Rural hamlet and isolated dwellings",1593,464,18,446,392,137,408,54,354
"2011","Barnsley","E08000016","Rural hamlet and isolated dwellings in a sparse setting",0,0,0,0,0,0,0,0,0
"2011","Doncaster","E08000017","Total",126487,47257,6456,40801,37497,15267,37005,6511,30494
"2011","Doncaster","E08000017","Urban (total)",109466,41121,5949,35172,32800,13641,32319,5724,26595
"2011","Doncaster","E08000017","Urban major conurbation",0,0,0,0,0,0,0,0,0
"2011","Doncaster","E08000017","Urban minor conurbation",90470,33683,4924,28759,27181,11361,26614,4726,21888
"2011","Doncaster","E08000017","Urban city and town",18996,7438,1025,6413,5619,2280,5705,998,4707
"2011","Doncaster","E08000017","Urban city and town in a sparse setting",0,0,0,0,0,0,0,0,0
"2011","Doncaster","E08000017","Rural (total)",17021,6136,507,5629,4697,1626,4686,787,3899
"2011","Doncaster","E08000017","Rural town and fringe",11595,4384,403,3981,3279,1159,3308,580,2728
"2011","Doncaster","E08000017","Rural town and fringe in a sparse setting",0,0,0,0,0,0,0,0,0
"2011","Doncaster","E08000017","Rural village",3591,1218,75,1143,913,312,912,127,785
"2011","Doncaster","E08000017","Rural village in a sparse setting",0,0,0,0,0,0,0,0,0
"2011","Doncaster","E08000017","Rural hamlet and isolated dwellings",1835,534,29,505,505,155,466,80,386
"2011","Doncaster","E08000017","Rural hamlet and isolated dwellings in a sparse setting",0,0,0,0,0,0,0,0,0
"2011","Rotherham","E08000018","Total",108293,40918,5392,35526,32275,12498,32144,5712,26432
"2011","Rotherham","E08000018","Urban (total)",97116,36832,5008,31824,29184,11328,28940,5218,23722
"2011","Rotherham","E08000018","Urban major conurbation",0,0,0,0,0,0,0,0,0
"2011","Rotherham","E08000018","Urban minor conurbation",78113,30024,4088,25936,23446,9179,23467,4209,19258
"2011","Rotherham","E08000018","Urban city and town",19003,6808,920,5888,5738,2149,5473,1009,4464
"2011","Rotherham","E08000018","Urban city and town in a sparse setting",0,0,0,0,0,0,0,0,0
"2011","Rotherham","E08000018","Rural (total)",11177,4086,384,3702,3091,1170,3204,494,2710
"2011","Rotherham","E08000018","Rural town and fringe",8734,3252,355,2897,2530,984,2594,418,2176
"2011","Rotherham","E08000018","Rural town and fringe in a sparse setting",0,0,0,0,0,0,0,0,0
"2011","Rotherham","E08000018","Rural village",1692,597,21,576,388,135,429,59,370
"2011","Rotherham","E08000018","Rural village in a sparse setting",0,0,0,0,0,0,0,0,0
"2011","Rotherham","E08000018","Rural hamlet and isolated dwellings",751,237,8,229,173,51,181,17,164
"2011","Rotherham","E08000018","Rural hamlet and isolated dwellings in a sparse setting",0,0,0,0,0,0,0,0,0
"2011","Sheffield","E08000019","Total",229928,83796,11179,72617,63851,26531,62189,10977,51212
"2011","Sheffield","E08000019","Urban (total)",225860,82566,11108,71458,62656,26142,61195,10831,50364
"2011","Sheffield","E08000019","Urban major conurbation",0,0,0,0,0,0,0,0,0
"2011","Sheffield","E08000019","Urban minor conurbation",218544,79865,10861,69004,60603,25343,59149,10482,48667
"2011","Sheffield","E08000019","Urban city and town",7316,2701,247,2454,2053,799,2046,349,1697
"2011","Sheffield","E08000019","Urban city and town in a sparse setting",0,0,0,0,0,0,0,0,0
"2011","Sheffield","E08000019","Rural (total)",4068,1230,71,1159,1195,389,994,146,848
"2011","Sheffield","E08000019","Rural town and fringe",2561,806,46,760,780,261,634,90,544
"2011","Sheffield","E08000019","Rural town and fringe in a sparse setting",0,0,0,0,0,0,0,0,0
"2011","Sheffield","E08000019","Rural village",702,232,16,216,196,54,184,33,151
"2011","Sheffield","E08000019","Rural village in a sparse setting",0,0,0,0,0,0,0,0,0
"2011","Sheffield","E08000019","Rural hamlet and isolated dwellings",805,192,9,183,219,74,176,23,153
"2011","Sheffield","E08000019","Rural hamlet and isolated dwellings in a sparse setting",0,0,0,0,0,0,0,0,0
"2011","Bradford","E08000032","Total",199296,68386,11843,56543,68747,30934,52958,12550,40408
"2011","Bradford","E08000032","Urban (total)",183887,63543,11555,51988,64576,29492,49275,11987,37288
"2011","Bradford","E08000032","Urban major conurbation",148110,51270,10122,41148,53408,24812,39937,10156,29781
"2011","Bradford","E08000032","Urban minor conurbation",0,0,0,0,0,0,0,0,0
"2011","Bradford","E08000032","Urban city and town",35777,12273,1433,10840,11168,4680,9338,1831,7507
"2011","Bradford","E08000032","Urban city and town in a sparse setting",0,0,0,0,0,0,0,0,0
"2011","Bradford","E08000032","Rural (total)",15409,4843,288,4555,4171,1442,3683,563,3120
"2011","Bradford","E08000032","Rural town and fringe",11581,3799,246,3553,3239,1125,2820,451,2369
"2011","Bradford","E08000032","Rural town and fringe in a sparse setting",0,0,0,0,0,0,0,0,0
"2011","Bradford","E08000032","Rural village",506,137,8,129,130,54,111,16,95
"2011","Bradford","E08000032","Rural village in a sparse setting",0,0,0,0,0,0,0,0,0
"2011","Bradford","E08000032","Rural hamlet and isolated dwellings",3322,907,34,873,802,263,752,96,656
"2011","Bradford","E08000032","Rural hamlet and isolated dwellings in a sparse setting",0,0,0,0,0,0,0,0,0
"2011","Calderdale","E08000033","Total",88621,30364,3575,26789,25996,10189,23341,4017,19324
"2011","Calderdale","E08000033","Urban (total)",71375,25478,3158,22320,20980,8419,19241,3308,15933
"2011","Calderdale","E08000033","Urban major conurbation",64298,22880,2855,20025,19040,7658,17171,2990,14181
"2011","Calderdale","E08000033","Urban minor conurbation",0,0,0,0,0,0,0,0,0
"2011","Calderdale","E08000033","Urban city and town",7077,2598,303,2295,1940,761,2070,318,1752
"2011","Calderdale","E08000033","Urban city and town in a sparse setting",0,0,0,0,0,0,0,0,0
"2011","Calderdale","E08000033","Rural (total)",17246,4886,417,4469,5016,1770,4100,709,3391
"2011","Calderdale","E08000033","Rural town and fringe",9136,2836,317,2519,2770,1033,2373,428,1945
"2011","Calderdale","E08000033","Rural town and fringe in a sparse setting",0,0,0,0,0,0,0,0,0
"2011","Calderdale","E08000033","Rural village",3154,846,43,803,895,303,674,111,563
"2011","Calderdale","E08000033","Rural village in a sparse setting",0,0,0,0,0,0,0,0,0
"2011","Calderdale","E08000033","Rural hamlet and isolated dwellings",4956,1204,57,1147,1351,434,1053,170,883
"2011","Calderdale","E08000033","Rural hamlet and isolated dwellings in a sparse setting",0,0,0,0,0,0,0,0,0
"2011","Kirklees","E08000034","Total",173525,59009,7642,51367,53538,22057,45375,8710,36665
"2011","Kirklees","E08000034","Urban (total)",153520,52958,7221,45737,47653,19943,40813,7935,32878
"2011","Kirklees","E08000034","Urban major conurbation",144104,50099,7024,43075,44952,18989,38674,7571,31103
"2011","Kirklees","E08000034","Urban minor conurbation",0,0,0,0,0,0,0,0,0
"2011","Kirklees","E08000034","Urban city and town",9416,2859,197,2662,2701,954,2139,364,1775
"2011","Kirklees","E08000034","Urban city and town in a sparse setting",0,0,0,0,0,0,0,0,0
"2011","Kirklees","E08000034","Rural (total)",20005,6051,421,5630,5885,2114,4562,775,3787
"2011","Kirklees","E08000034","Rural town and fringe",14035,4374,340,4034,4135,1523,3285,569,2716
"2011","Kirklees","E08000034","Rural town and fringe in a sparse setting",0,0,0,0,0,0,0,0,0
"2011","Kirklees","E08000034","Rural village",3280,1008,43,965,950,344,732,104,628
"2011","Kirklees","E08000034","Rural village in a sparse setting",0,0,0,0,0,0,0,0,0
"2011","Kirklees","E08000034","Rural hamlet and isolated dwellings",2690,669,38,631,800,247,545,102,443
"2011","Kirklees","E08000034","Rural hamlet and isolated dwellings in a sparse setting",0,0,0,0,0,0,0,0,0
"2011","Leeds","E08000035","Total",320596,109082,14212,94870,88415,37640,79413,13499,65914
"2011","Leeds","E08000035","Urban (total)",302423,102965,13895,89070,83369,35755,75092,12836,62256
"2011","Leeds","E08000035","Urban major conurbation",280138,95186,13470,81716,77172,33565,69546,12028,57518
"2011","Leeds","E08000035","Urban minor conurbation",0,0,0,0,0,0,0,0,0
"2011","Leeds","E08000035","Urban city and town",22285,7779,425,7354,6197,2190,5546,808,4738
"2011","Leeds","E08000035","Urban city and town in a sparse setting",0,0,0,0,0,0,0,0,0
"2011","Leeds","E08000035","Rural (total)",18173,6117,317,5800,5046,1885,4321,663,3658
"2011","Leeds","E08000035","Rural town and fringe",13069,4550,230,4320,3622,1388,3201,475,2726
"2011","Leeds","E08000035","Rural town and fringe in a sparse setting",0,0,0,0,0,0,0,0,0
"2011","Leeds","E08000035","Rural village",3540,1130,64,1066,983,357,788,130,658
"2011","Leeds","E08000035","Rural village in a sparse setting",0,0,0,0,0,0,0,0,0
"2011","Leeds","E08000035","Rural hamlet and isolated dwellings",1564,437,23,414,441,140,332,58,274
"2011","Leeds","E08000035","Rural hamlet and isolated dwellings in a sparse setting",0,0,0,0,0,0,0,0,0
"2011","Wakefield","E08000036","Total",140414,51215,6230,44985,40538,15665,40825,6803,34022
"2011","Wakefield","E08000036","Urban (total)",115954,42210,5208,37002,33451,13040,33584,5545,28039
"2011","Wakefield","E08000036","Urban major conurbation",55626,19276,2181,17095,15861,6138,15093,2509,12584
"2011","Wakefield","E08000036","Urban minor conurbation",0,0,0,0,0,0,0,0,0
"2011","Wakefield","E08000036","Urban city and town",60328,22934,3027,19907,17590,6902,18491,3036,15455
"2011","Wakefield","E08000036","Urban city and town in a sparse setting",0,0,0,0,0,0,0,0,0
"2011","Wakefield","E08000036","Rural (total)",24460,9005,1022,7983,7087,2625,7241,1258,5983
"2011","Wakefield","E08000036","Rural town and fringe",18921,7071,910,6161,5732,2190,5787,1050,4737
"2011","Wakefield","E08000036","Rural town and fringe in a sparse setting",0,0,0,0,0,0,0,0,0
"2011","Wakefield","E08000036","Rural village",4603,1666,96,1570,1120,366,1216,173,1043
"2011","Wakefield","E08000036","Rural village in a sparse setting",0,0,0,0,0,0,0,0,0
"2011","Wakefield","E08000036","Rural hamlet and isolated dwellings",936,268,16,252,235,69,238,35,203
"2011","Wakefield","E08000036","Rural hamlet and isolated dwellings in a sparse setting",0,0,0,0,0,0,0,0,0
"2011","Derby","E06000015","Total",102271,35909,5221,30688,31554,13632,27553,5342,22211
"2011","Derby","E06000015","Urban (total)",102271,35909,5221,30688,31554,13632,27553,5342,22211
"2011","Derby","E06000015","Urban major conurbation",0,0,0,0,0,0,0,0,0
"2011","Derby","E06000015","Urban minor conurbation",0,0,0,0,0,0,0,0,0
"2011","Derby","E06000015","Urban city and town",102271,35909,5221,30688,31554,13632,27553,5342,22211
"2011","Derby","E06000015","Urban city and town in a sparse setting",0,0,0,0,0,0,0,0,0
"2011","Derby","E06000015","Rural (total)",0,0,0,0,0,0,0,0,0
"2011","Derby","E06000015","Rural town and fringe",0,0,0,0,0,0,0,0,0
"2011","Derby","E06000015","Rural town and fringe in a sparse setting",0,0,0,0,0,0,0,0,0
"2011","Derby","E06000015","Rural village",0,0,0,0,0,0,0,0,0
"2011","Derby","E06000015","Rural village in a sparse setting",0,0,0,0,0,0,0,0,0
"2011","Derby","E06000015","Rural hamlet and isolated dwellings",0,0,0,0,0,0,0,0,0
"2011","Derby","E06000015","Rural hamlet and isolated dwellings in a sparse setting",0,0,0,0,0,0,0,0,0
"2011","Leicester","E06000016","Total",123125,42115,8551,33564,41139,18734,32447,7909,24538
"2011","Leicester","E06000016","Urban (total)",122951,42097,8547,33550,41055,18707,32423,7897,24526
"2011","Leicester","E06000016","Urban major conurbation",0,0,0,0,0,0,0,0,0
"2011","Leicester","E06000016","Urban minor conurbation",0,0,0,0,0,0,0,0,0
"2011","Leicester","E06000016","Urban city and town",122951,42097,8547,33550,41055,18707,32423,7897,24526
"2011","Leicester","E06000016","Urban city and town in a sparse setting",0,0,0,0,0,0,0,0,0
"2011","Leicester","E06000016","Rural (total)",174,18,4,14,84,27,24,12,12
"2011","Leicester","E06000016","Rural town and fringe",0,0,0,0,0,0,0,0,0
"2011","Leicester","E06000016","Rural town and fringe in a sparse setting",0,0,0,0,0,0,0,0,0
"2011","Leicester","E06000016","Rural village",0,0,0,0,0,0,0,0,0
"2011","Leicester","E06000016","Rural village in a sparse setting",0,0,0,0,0,0,0,0,0
"2011","Leicester","E06000016","Rural hamlet and isolated dwellings",174,18,4,14,84,27,24,12,12
"2011","Leicester","E06000016","Rural hamlet and isolated dwellings in a sparse setting",0,0,0,0,0,0,0,0,0
"2011","Nottingham","E06000018","Total",126131,48896,8685,40211,34516,15661,34244,6447,27797
"2011","Nottingham","E06000018","Urban (total)",126131,48896,8685,40211,34516,15661,34244,6447,27797
"2011","Nottingham","E06000018","Urban major conurbation",0,0,0,0,0,0,0,0,0
"2011","Nottingham","E06000018","Urban minor conurbation",126131,48896,8685,40211,34516,15661,34244,6447,27797
"2011","Nottingham","E06000018","Urban city and town",0,0,0,0,0,0,0,0,0
"2011","Nottingham","E06000018","Urban city and town in a sparse setting",0,0,0,0,0,0,0,0,0
"2011","Nottingham","E06000018","Rural (total)",0,0,0,0,0,0,0,0,0
"2011","Nottingham","E06000018","Rural town and fringe",0,0,0,0,0,0,0,0,0
"2011","Nottingham","E06000018","Rural town and fringe in a sparse setting",0,0,0,0,0,0,0,0,0
"2011","Nottingham","E06000018","Rural village",0,0,0,0,0,0,0,0,0
"2011","Nottingham","E06000018","Rural village in a sparse setting",0,0,0,0,0,0,0,0,0
"2011","Nottingham","E06000018","Rural hamlet and isolated dwellings",0,0,0,0,0,0,0,0,0
"2011","Nottingham","E06000018","Rural hamlet and isolated dwellings in a sparse setting",0,0,0,0,0,0,0,0,0
"2011","Rutland","E06000017","Total",15002,4931,235,4696,3971,1404,3538,456,3082
"2011","Rutland","E06000017","Urban (total)",4904,1731,97,1634,1266,437,1253,160,1093
"2011","Rutland","E06000017","Urban major conurbation",0,0,0,0,0,0,0,0,0
"2011","Rutland","E06000017","Urban minor conurbation",0,0,0,0,0,0,0,0,0
"2011","Rutland","E06000017","Urban city and town",4904,1731,97,1634,1266,437,1253,160,1093
"2011","Rutland","E06000017","Urban city and town in a sparse setting",0,0,0,0,0,0,0,0,0
"2011","Rutland","E06000017","Rural (total)",10098,3200,138,3062,2705,967,2285,296,1989
"2011","Rutland","E06000017","Rural town and fringe",3617,1266,60,1206,943,338,877,91,786
"2011","Rutland","E06000017","Rural town and fringe in a sparse setting",0,0,0,0,0,0,0,0,0
"2011","Rutland","E06000017","Rural village",6219,1865,71,1794,1690,604,1354,192,1162
"2011","Rutland","E06000017","Rural village in a sparse setting",0,0,0,0,0,0,0,0,0
"2011","Rutland","E06000017","Rural hamlet and isolated dwellings",262,69,7,62,72,25,54,13,41
"2011","Rutland","E06000017","Rural hamlet and isolated dwellings in a sparse setting",0,0,0,0,0,0,0,0,0
"2011","Derbyshire","E10000007","Total",332637,114988,11193,103795,91923,33225,91851,15007,76844
"2011","Derbyshire","E10000007","Urban (total)",244048,85461,9146,76315,68312,25201,68595,11455,57140
"2011","Derbyshire","E10000007","Urban major conurbation",13125,4117,486,3631,4104,1532,3490,653,2837
"2011","Derbyshire","E10000007","Urban minor conurbation",89755,31005,3542,27463,25336,9442,24691,4129,20562
"2011","Derbyshire","E10000007","Urban city and town",141168,50339,5118,45221,38872,14227,40414,6673,33741
"2011","Derbyshire","E10000007","Urban city and town in a sparse setting",0,0,0,0,0,0,0,0,0
"2011","Derbyshire","E10000007","Rural (total)",88589,29527,2047,27480,23611,8024,23256,3552,19704
"2011","Derbyshire","E10000007","Rural town and fringe",48133,16420,1378,15042,13523,4857,12989,2131,10858
"2011","Derbyshire","E10000007","Rural town and fringe in a sparse setting",0,0,0,0,0,0,0,0,0
"2011","Derbyshire","E10000007","Rural village",27867,9546,535,9011,6914,2196,7354,989,6365
"2011","Derbyshire","E10000007","Rural village in a sparse setting",0,0,0,0,0,0,0,0,0
"2011","Derbyshire","E10000007","Rural hamlet and isolated dwellings",12589,3561,134,3427,3174,971,2913,432,2481
"2011","Derbyshire","E10000007","Rural hamlet and isolated dwellings in a sparse setting",0,0,0,0,0,0,0,0,0
"2011","Leicestershire","E10000018","Total",267434,82735,6330,76405,77393,28565,63613,10530,53083
"2011","Leicestershire","E10000018","Urban (total)",185094,58307,4884,53423,53767,20516,44634,7496,37138
"2011","Leicestershire","E10000018","Urban major conurbation",0,0,0,0,0,0,0,0,0
"2011","Leicestershire","E10000018","Urban minor conurbation",0,0,0,0,0,0,0,0,0
"2011","Leicestershire","E10000018","Urban city and town",185094,58307,4884,53423,53767,20516,44634,7496,37138
"2011","Leicestershire","E10000018","Urban city and town in a sparse setting",0,0,0,0,0,0,0,0,0
"2011","Leicestershire","E10000018","Rural (total)",82340,24428,1446,22982,23626,8049,18979,3034,15945
"2011","Leicestershire","E10000018","Rural town and fringe",48243,14974,967,14007,14042,4907,11509,1837,9672
"2011","Leicestershire","E10000018","Rural town and fringe in a sparse setting",0,0,0,0,0,0,0,0,0
"2011","Leicestershire","E10000018","Rural village",28637,8020,405,7615,8106,2651,6276,1014,5262
"2011","Leicestershire","E10000018","Rural village in a sparse setting",0,0,0,0,0,0,0,0,0
"2011","Leicestershire","E10000018","Rural hamlet and isolated dwellings",5460,1434,74,1360,1478,491,1194,183,1011
"2011","Leicestershire","E10000018","Rural hamlet and isolated dwellings in a sparse setting",0,0,0,0,0,0,0,0,0
"2011","Lincolnshire","E10000019","Total",306971,111914,9851,102063,80944,29767,83118,12912,70206
"2011","Lincolnshire","E10000019","Urban (total)",160854,58706,6200,52506,42971,17199,43325,6800,36525
"2011","Lincolnshire","E10000019","Urban major conurbation",0,0,0,0,0,0,0,0,0
"2011","Lincolnshire","E10000019","Urban minor conurbation",0,0,0,0,0,0,0,0,0
"2011","Lincolnshire","E10000019","Urban city and town",154973,54949,5954,48995,42055,16883,41072,6588,34484
"2011","Lincolnshire","E10000019","Urban city and town in a sparse setting",5881,3757,246,3511,916,316,2253,212,2041
"2011","Lincolnshire","E10000019","Rural (total)",146117,53208,3651,49557,37973,12568,39793,6112,33681
"2011","Lincolnshire","E10000019","Rural town and fringe",64154,24775,1647,23128,16730,5807,17818,2583,15235
"2011","Lincolnshire","E10000019","Rural town and fringe in a sparse setting",2916,1263,148,1115,811,331,888,145,743
"2011","Lincolnshire","E10000019","Rural village",50425,17280,1194,16086,13550,4408,13260,2148,11112
"2011","Lincolnshire","E10000019","Rural village in a sparse setting",4935,2130,126,2004,1028,286,1527,219,1308
"2011","Lincolnshire","E10000019","Rural hamlet and isolated dwellings",20413,6563,445,6118,5099,1500,5350,858,4492
"2011","Lincolnshire","E10000019","Rural hamlet and isolated dwellings in a sparse setting",3274,1197,91,1106,755,236,950,159,791
"2011","Northamptonshire","E10000021","Total",287730,85062,10049,75013,88154,36233,68791,12629,56162
"2011","Northamptonshire","E10000021","Urban (total)",197107,59446,8355,51091,61613,26884,48400,9251,39149
"2011","Northamptonshire","E10000021","Urban major conurbation",0,0,0,0,0,0,0,0,0
"2011","Northamptonshire","E10000021","Urban minor conurbation",0,0,0,0,0,0,0,0,0
"2011","Northamptonshire","E10000021","Urban city and town",197107,59446,8355,51091,61613,26884,48400,9251,39149
"2011","Northamptonshire","E10000021","Urban city and town in a sparse setting",0,0,0,0,0,0,0,0,0
"2011","Northamptonshire","E10000021","Rural (total)",90623,25616,1694,23922,26541,9349,20391,3378,17013
"2011","Northamptonshire","E10000021","Rural town and fringe",55294,15644,1199,14445,16837,6226,12551,2147,10404
"2011","Northamptonshire","E10000021","Rural town and fringe in a sparse setting",0,0,0,0,0,0,0,0,0
"2011","Northamptonshire","E10000021","Rural village",30256,8696,443,8253,8299,2668,6749,1049,5700
"2011","Northamptonshire","E10000021","Rural village in a sparse setting",0,0,0,0,0,0,0,0,0
"2011","Northamptonshire","E10000021","Rural hamlet and isolated dwellings",5073,1276,52,1224,1405,455,1091,182,909
"2011","Northamptonshire","E10000021","Rural hamlet and isolated dwellings in a sparse setting",0,0,0,0,0,0,0,0,0
"2011","Nottinghamshire","E10000024","Total",334303,115405,11748,103657,95191,35967,91443,15310,76133
"2011","Nottinghamshire","E10000024","Urban (total)",245825,84195,9405,74790,70769,27696,67308,11399,55909
"2011","Nottinghamshire","E10000024","Urban major conurbation",0,0,0,0,0,0,0,0,0
"2011","Nottinghamshire","E10000024","Urban minor conurbation",120305,39226,3708,35518,34325,13343,30892,5034,25858
"2011","Nottinghamshire","E10000024","Urban city and town",125520,44969,5697,39272,36444,14353,36416,6365,30051
"2011","Nottinghamshire","E10000024","Urban city and town in a sparse setting",0,0,0,0,0,0,0,0,0
"2011","Nottinghamshire","E10000024","Rural (total)",88478,31210,2343,28867,24422,8271,24135,3911,20224
"2011","Nottinghamshire","E10000024","Rural town and fringe",59084,22021,1860,20161,16434,5791,16826,2748,14078
"2011","Nottinghamshire","E10000024","Rural town and fringe in a sparse setting",0,0,0,0,0,0,0,0,0
"2011","Nottinghamshire","E10000024","Rural village",22821,7217,385,6832,6230,1949,5662,888,4774
"2011","Nottinghamshire","E10000024","Rural village in a sparse setting",0,0,0,0,0,0,0,0,0
"2011","Nottinghamshire","E10000024","Rural hamlet and isolated dwellings",6573,1972,98,1874,1758,531,1647,275,1372
"2011","Nottinghamshire","E10000024","Rural hamlet and isolated dwellings in a sparse setting",0,0,0,0,0,0,0,0,0
"2011","Herefordshire, County of","E06000019","Total",78319,26710,2111,24599,20724,7567,20842,3269,17573
"2011","Herefordshire, County of","E06000019","Urban (total)",36652,12576,1302,11274,10205,4168,9979,1667,8312
"2011","Herefordshire, County of","E06000019","Urban major conurbation",0,0,0,0,0,0,0,0,0
"2011","Herefordshire, County of","E06000019","Urban minor conurbation",0,0,0,0,0,0,0,0,0
"2011","Herefordshire, County of","E06000019","Urban city and town",35851,12303,1225,11078,9908,4041,9750,1601,8149
"2011","Herefordshire, County of","E06000019","Urban city and town in a sparse setting",801,273,77,196,297,127,229,66,163
"2011","Herefordshire, County of","E06000019","Rural (total)",41667,14134,809,13325,10519,3399,10863,1602,9261
"2011","Herefordshire, County of","E06000019","Rural town and fringe",6809,2678,188,2490,1767,687,1979,293,1686
"2011","Herefordshire, County of","E06000019","Rural town and fringe in a sparse setting",1121,452,47,405,272,113,328,40,288
"2011","Herefordshire, County of","E06000019","Rural village",13618,4711,273,4438,3529,1120,3592,525,3067
"2011","Herefordshire, County of","E06000019","Rural village in a sparse setting",2889,1051,70,981,713,216,780,109,671
"2011","Herefordshire, County of","E06000019","Rural hamlet and isolated dwellings",12619,3805,164,3641,3120,924,3036,465,2571
"2011","Herefordshire, County of","E06000019","Rural hamlet and isolated dwellings in a sparse setting",4611,1437,67,1370,1118,339,1148,170,978
"2011","Shropshire","E06000051","Total",129674,43220,3127,40093,34303,12374,33713,5098,28615
"2011","Shropshire","E06000051","Urban (total)",57625,19688,1704,17984,15203,5916,15182,2320,12862
"2011","Shropshire","E06000051","Urban major conurbation",0,0,0,0,0,0,0,0,0
"2011","Shropshire","E06000051","Urban minor conurbation",0,0,0,0,0,0,0,0,0
"2011","Shropshire","E06000051","Urban city and town",52639,17666,1541,16125,14105,5500,13722,2151,11571
"2011","Shropshire","E06000051","Urban city and town in a sparse setting",4986,2022,163,1859,1098,416,1460,169,1291
"2011","Shropshire","E06000051","Rural (total)",72049,23532,1423,22109,19100,6458,18531,2778,15753
"2011","Shropshire","E06000051","Rural town and fringe",28321,10540,687,9853,7495,2663,7803,1117,6686
"2011","Shropshire","E06000051","Rural town and fringe in a sparse setting",1935,714,75,639,490,183,553,82,471
"2011","Shropshire","E06000051","Rural village",17112,5474,320,5154,4740,1641,4265,672,3593
"2011","Shropshire","E06000051","Rural village in a sparse setting",2089,780,20,760,450,137,595,75,520
"2011","Shropshire","E06000051","Rural hamlet and isolated dwellings",18911,4929,276,4653,5073,1552,4401,707,3694
"2011","Shropshire","E06000051","Rural hamlet and isolated dwellings in a sparse setting",3681,1095,45,1050,852,282,914,125,789
"2011","Stoke-on-Trent","E06000021","Total",107575,41503,6318,35185,31277,13444,32666,5869,26797
"2011","Stoke-on-Trent","E06000021","Urban (total)",107272,41368,6296,35072,31212,13415,32558,5855,26703
"2011","Stoke-on-Trent","E06000021","Urban major conurbation",0,0,0,0,0,0,0,0,0
"2011","Stoke-on-Trent","E06000021","Urban minor conurbation",0,0,0,0,0,0,0,0,0
"2011","Stoke-on-Trent","E06000021","Urban city and town",107272,41368,6296,35072,31212,13415,32558,5855,26703
"2011","Stoke-on-Trent","E06000021","Urban city and town in a sparse setting",0,0,0,0,0,0,0,0,0
"2011","Stoke-on-Trent","E06000021","Rural (total)",303,135,22,113,65,29,108,14,94
"2011","Stoke-on-Trent","E06000021","Rural town and fringe",0,0,0,0,0,0,0,0,0
"2011","Stoke-on-Trent","E06000021","Rural town and fringe in a sparse setting",0,0,0,0,0,0,0,0,0
"2011","Stoke-on-Trent","E06000021","Rural village",225,101,9,92,42,17,88,8,80
"2011","Stoke-on-Trent","E06000021","Rural village in a sparse setting",0,0,0,0,0,0,0,0,0
"2011","Stoke-on-Trent","E06000021","Rural hamlet and isolated dwellings",78,34,13,21,23,12,20,6,14
"2011","Stoke-on-Trent","E06000021","Rural hamlet and isolated dwellings in a sparse setting",0,0,0,0,0,0,0,0,0
"2011","Telford and Wrekin","E06000020","Total",66608,21657,3707,17950,22003,8882,17987,3880,14107
"2011","Telford and Wrekin","E06000020","Urban (total)",62445,20386,3624,16762,20871,8556,16956,3704,13252
"2011","Telford and Wrekin","E06000020","Urban major conurbation",0,0,0,0,0,0,0,0,0
"2011","Telford and Wrekin","E06000020","Urban minor conurbation",0,0,0,0,0,0,0,0,0
"2011","Telford and Wrekin","E06000020","Urban city and town",62445,20386,3624,16762,20871,8556,16956,3704,13252
"2011","Telford and Wrekin","E06000020","Urban city and town in a sparse setting",0,0,0,0,0,0,0,0,0
"2011","Telford and Wrekin","E06000020","Rural (total)",4163,1271,83,1188,1132,326,1031,176,855
"2011","Telford and Wrekin","E06000020","Rural town and fringe",208,38,23,15,122,57,37,26,11
"2011","Telford and Wrekin","E06000020","Rural town and fringe in a sparse setting",0,0,0,0,0,0,0,0,0
"2011","Telford and Wrekin","E06000020","Rural village",2405,862,36,826,596,147,650,89,561
"2011","Telford and Wrekin","E06000020","Rural village in a sparse setting",0,0,0,0,0,0,0,0,0
"2011","Telford and Wrekin","E06000020","Rural hamlet and isolated dwellings",1550,371,24,347,414,122,344,61,283
"2011","Telford and Wrekin","E06000020","Rural hamlet and isolated dwellings in a sparse setting",0,0,0,0,0,0,0,0,0
"2011","Staffordshire","E10000028","Total",355263,118699,10868,107831,100897,36889,94393,15790,78603
"2011","Staffordshire","E10000028","Urban (total)",271702,91873,9398,82475,78757,29769,73292,12561,60731
"2011","Staffordshire","E10000028","Urban major conurbation",64280,21376,2142,19234,18948,6702,17547,3120,14427
"2011","Staffordshire","E10000028","Urban minor conurbation",0,0,0,0,0,0,0,0,0
"2011","Staffordshire","E10000028","Urban city and town",207422,70497,7256,63241,59809,23067,55745,9441,46304
"2011","Staffordshire","E10000028","Urban city and town in a sparse setting",0,0,0,0,0,0,0,0,0
"2011","Staffordshire","E10000028","Rural (total)",83561,26826,1470,25356,22140,7120,21101,3229,17872
"2011","Staffordshire","E10000028","Rural town and fringe",40234,13458,886,12572,11202,3726,10521,1651,8870
"2011","Staffordshire","E10000028","Rural town and fringe in a sparse setting",0,0,0,0,0,0,0,0,0
"2011","Staffordshire","E10000028","Rural village",24879,8313,343,7970,6190,2000,6249,886,5363
"2011","Staffordshire","E10000028","Rural village in a sparse setting",0,0,0,0,0,0,0,0,0
"2011","Staffordshire","E10000028","Rural hamlet and isolated dwellings",18448,5055,241,4814,4748,1394,4331,692,3639
"2011","Staffordshire","E10000028","Rural hamlet and isolated dwellings in a sparse setting",0,0,0,0,0,0,0,0,0
"2011","Warwickshire","E10000031","Total",231005,73187,6471,66716,64990,24787,56442,9285,47157
"2011","Warwickshire","E10000031","Urban (total)",155468,49828,5075,44753,44152,17702,38223,6420,31803
"2011","Warwickshire","E10000031","Urban major conurbation",0,0,0,0,0,0,0,0,0
"2011","Warwickshire","E10000031","Urban minor conurbation",0,0,0,0,0,0,0,0,0
"2011","Warwickshire","E10000031","Urban city and town",155468,49828,5075,44753,44152,17702,38223,6420,31803
"2011","Warwickshire","E10000031","Urban city and town in a sparse setting",0,0,0,0,0,0,0,0,0
"2011","Warwickshire","E10000031","Rural (total)",75537,23359,1396,21963,20838,7085,18219,2865,15354
"2011","Warwickshire","E10000031","Rural town and fringe",39302,12434,873,11561,11231,3949,9802,1581,8221
"2011","Warwickshire","E10000031","Rural town and fringe in a sparse setting",0,0,0,0,0,0,0,0,0
"2011","Warwickshire","E10000031","Rural village",25180,7834,400,7434,6831,2262,5975,919,5056
"2011","Warwickshire","E10000031","Rural village in a sparse setting",0,0,0,0,0,0,0,0,0
"2011","Warwickshire","E10000031","Rural hamlet and isolated dwellings",11055,3091,123,2968,2776,874,2442,365,2077
"2011","Warwickshire","E10000031","Rural hamlet and isolated dwellings in a sparse setting",0,0,0,0,0,0,0,0,0
"2011","Birmingham","E08000025","Total",410736,151000,31743,119257,139418,61989,115167,27531,87636
"2011","Birmingham","E08000025","Urban (total)",410515,150956,31742,119214,139352,61959,115132,27522,87610
"2011","Birmingham","E08000025","Urban major conurbation",410515,150956,31742,119214,139352,61959,115132,27522,87610
"2011","Birmingham","E08000025","Urban minor conurbation",0,0,0,0,0,0,0,0,0
"2011","Birmingham","E08000025","Urban city and town",0,0,0,0,0,0,0,0,0
"2011","Birmingham","E08000025","Urban city and town in a sparse setting",0,0,0,0,0,0,0,0,0
"2011","Birmingham","E08000025","Rural (total)",221,44,1,43,66,30,35,9,26
"2011","Birmingham","E08000025","Rural town and fringe",0,0,0,0,0,0,0,0,0
"2011","Birmingham","E08000025","Rural town and fringe in a sparse setting",0,0,0,0,0,0,0,0,0
"2011","Birmingham","E08000025","Rural village",0,0,0,0,0,0,0,0,0
"2011","Birmingham","E08000025","Rural village in a sparse setting",0,0,0,0,0,0,0,0,0
"2011","Birmingham","E08000025","Rural hamlet and isolated dwellings",221,44,1,43,66,30,35,9,26
"2011","Birmingham","E08000025","Rural hamlet and isolated dwellings in a sparse setting",0,0,0,0,0,0,0,0,0
"2011","Coventry","E08000026","Total",128592,47618,7737,39881,39894,17733,34125,6858,27267
"2011","Coventry","E08000026","Urban (total)",128378,47541,7736,39805,39849,17717,34065,6851,27214
"2011","Coventry","E08000026","Urban major conurbation",0,0,0,0,0,0,0,0,0
"2011","Coventry","E08000026","Urban minor conurbation",0,0,0,0,0,0,0,0,0
"2011","Coventry","E08000026","Urban city and town",128378,47541,7736,39805,39849,17717,34065,6851,27214
"2011","Coventry","E08000026","Urban city and town in a sparse setting",0,0,0,0,0,0,0,0,0
"2011","Coventry","E08000026","Rural (total)",214,77,1,76,45,16,60,7,53
"2011","Coventry","E08000026","Rural town and fringe",0,0,0,0,0,0,0,0,0
"2011","Coventry","E08000026","Rural town and fringe in a sparse setting",0,0,0,0,0,0,0,0,0
"2011","Coventry","E08000026","Rural village",0,0,0,0,0,0,0,0,0
"2011","Coventry","E08000026","Rural village in a sparse setting",0,0,0,0,0,0,0,0,0
"2011","Coventry","E08000026","Rural hamlet and isolated dwellings",214,77,1,76,45,16,60,7,53
"2011","Coventry","E08000026","Rural hamlet and isolated dwellings in a sparse setting",0,0,0,0,0,0,0,0,0
"2011","Dudley","E08000027","Total",129867,47313,6032,41281,38620,14933,36266,6532,29734
"2011","Dudley","E08000027","Urban (total)",129757,47279,6031,41248,38584,14923,36238,6526,29712
"2011","Dudley","E08000027","Urban major conurbation",129651,47244,6031,41213,38547,14909,36208,6522,29686
"2011","Dudley","E08000027","Urban minor conurbation",0,0,0,0,0,0,0,0,0
"2011","Dudley","E08000027","Urban city and town",106,35,0,35,37,14,30,4,26
"2011","Dudley","E08000027","Urban city and town in a sparse setting",0,0,0,0,0,0,0,0,0
"2011","Dudley","E08000027","Rural (total)",110,34,1,33,36,10,28,6,22
"2011","Dudley","E08000027","Rural town and fringe",110,34,1,33,36,10,28,6,22
"2011","Dudley","E08000027","Rural town and fringe in a sparse setting",0,0,0,0,0,0,0,0,0
"2011","Dudley","E08000027","Rural village",0,0,0,0,0,0,0,0,0
"2011","Dudley","E08000027","Rural village in a sparse setting",0,0,0,0,0,0,0,0,0
"2011","Dudley","E08000027","Rural hamlet and isolated dwellings",0,0,0,0,0,0,0,0,0
"2011","Dudley","E08000027","Rural hamlet and isolated dwellings in a sparse setting",0,0,0,0,0,0,0,0,0
"2011","Sandwell","E08000028","Total",121498,45765,8514,37251,41046,17756,36323,7866,28457
"2011","Sandwell","E08000028","Urban (total)",121498,45765,8514,37251,41046,17756,36323,7866,28457
"2011","Sandwell","E08000028","Urban major conurbation",121498,45765,8514,37251,41046,17756,36323,7866,28457
"2011","Sandwell","E08000028","Urban minor conurbation",0,0,0,0,0,0,0,0,0
"2011","Sandwell","E08000028","Urban city and town",0,0,0,0,0,0,0,0,0
"2011","Sandwell","E08000028","Urban city and town in a sparse setting",0,0,0,0,0,0,0,0,0
"2011","Sandwell","E08000028","Rural (total)",0,0,0,0,0,0,0,0,0
"2011","Sandwell","E08000028","Rural town and fringe",0,0,0,0,0,0,0,0,0
"2011","Sandwell","E08000028","Rural town and fringe in a sparse setting",0,0,0,0,0,0,0,0,0
"2011","Sandwell","E08000028","Rural village",0,0,0,0,0,0,0,0,0
"2011","Sandwell","E08000028","Rural village in a sparse setting",0,0,0,0,0,0,0,0,0
"2011","Sandwell","E08000028","Rural hamlet and isolated dwellings",0,0,0,0,0,0,0,0,0
"2011","Sandwell","E08000028","Rural hamlet and isolated dwellings in a sparse setting",0,0,0,0,0,0,0,0,0
"2011","Solihull","E08000029","Total",86056,29972,3090,26882,25962,9204,22256,3823,18433
"2011","Solihull","E08000029","Urban (total)",77586,27762,2962,24800,23397,8333,20593,3508,17085
"2011","Solihull","E08000029","Urban major conurbation",76104,27313,2943,24370,22973,8195,20256,3460,16796
"2011","Solihull","E08000029","Urban minor conurbation",0,0,0,0,0,0,0,0,0
"2011","Solihull","E08000029","Urban city and town",1482,449,19,430,424,138,337,48,289
"2011","Solihull","E08000029","Urban city and town in a sparse setting",0,0,0,0,0,0,0,0,0
"2011","Solihull","E08000029","Rural (total)",8470,2210,128,2082,2565,871,1663,315,1348
"2011","Solihull","E08000029","Rural town and fringe",6019,1534,96,1438,1918,666,1163,238,925
"2011","Solihull","E08000029","Rural town and fringe in a sparse setting",0,0,0,0,0,0,0,0,0
"2011","Solihull","E08000029","Rural village",1038,274,9,265,264,94,198,25,173
"2011","Solihull","E08000029","Rural village in a sparse setting",0,0,0,0,0,0,0,0,0
"2011","Solihull","E08000029","Rural hamlet and isolated dwellings",1413,402,23,379,383,111,302,52,250
"2011","Solihull","E08000029","Rural hamlet and isolated dwellings in a sparse setting",0,0,0,0,0,0,0,0,0
"2011","Walsall","E08000030","Total",107822,41659,6926,34733,34509,14256,31599,6412,25187
"2011","Walsall","E08000030","Urban (total)",106582,41193,6868,34325,34176,14131,31237,6359,24878
"2011","Walsall","E08000030","Urban major conurbation",106338,41116,6867,34249,34112,14114,31189,6349,24840
"2011","Walsall","E08000030","Urban minor conurbation",0,0,0,0,0,0,0,0,0
"2011","Walsall","E08000030","Urban city and town",244,77,1,76,64,17,48,10,38
"2011","Walsall","E08000030","Urban city and town in a sparse setting",0,0,0,0,0,0,0,0,0
"2011","Walsall","E08000030","Rural (total)",1240,466,58,408,333,125,362,53,309
"2011","Walsall","E08000030","Rural town and fringe",889,310,54,256,265,104,263,42,221
"2011","Walsall","E08000030","Rural town and fringe in a sparse setting",0,0,0,0,0,0,0,0,0
"2011","Walsall","E08000030","Rural village",282,114,3,111,64,20,74,10,64
"2011","Walsall","E08000030","Rural village in a sparse setting",0,0,0,0,0,0,0,0,0
"2011","Walsall","E08000030","Rural hamlet and isolated dwellings",69,42,1,41,4,1,25,1,24
"2011","Walsall","E08000030","Rural hamlet and isolated dwellings in a sparse setting",0,0,0,0,0,0,0,0,0
"2011","Wolverhampton","E08000031","Total",102177,40296,7287,33009,31987,13068,29679,5964,23715
"2011","Wolverhampton","E08000031","Urban (total)",102177,40296,7287,33009,31987,13068,29679,5964,23715
"2011","Wolverhampton","E08000031","Urban major conurbation",102177,40296,7287,33009,31987,13068,29679,5964,23715
"2011","Wolverhampton","E08000031","Urban minor conurbation",0,0,0,0,0,0,0,0,0
"2011","Wolverhampton","E08000031","Urban city and town",0,0,0,0,0,0,0,0,0
"2011","Wolverhampton","E08000031","Urban city and town in a sparse setting",0,0,0,0,0,0,0,0,0
"2011","Wolverhampton","E08000031","Rural (total)",0,0,0,0,0,0,0,0,0
"2011","Wolverhampton","E08000031","Rural town and fringe",0,0,0,0,0,0,0,0,0
"2011","Wolverhampton","E08000031","Rural town and fringe in a sparse setting",0,0,0,0,0,0,0,0,0
"2011","Wolverhampton","E08000031","Rural village",0,0,0,0,0,0,0,0,0
"2011","Wolverhampton","E08000031","Rural village in a sparse setting",0,0,0,0,0,0,0,0,0
"2011","Wolverhampton","E08000031","Rural hamlet and isolated dwellings",0,0,0,0,0,0,0,0,0
"2011","Wolverhampton","E08000031","Rural hamlet and isolated dwellings in a sparse setting",0,0,0,0,0,0,0,0,0
"2011","Worcestershire","E10000034","Total",239717,78859,7248,71611,66663,24746,61107,9870,51237
"2011","Worcestershire","E10000034","Urban (total)",176907,57517,6198,51319,51079,19843,45259,7723,37536
"2011","Worcestershire","E10000034","Urban major conurbation",7820,2739,144,2595,2176,694,2078,320,1758
"2011","Worcestershire","E10000034","Urban minor conurbation",0,0,0,0,0,0,0,0,0
"2011","Worcestershire","E10000034","Urban city and town",169087,54778,6054,48724,48903,19149,43181,7403,35778
"2011","Worcestershire","E10000034","Urban city and town in a sparse setting",0,0,0,0,0,0,0,0,0
"2011","Worcestershire","E10000034","Rural (total)",62810,21342,1050,20292,15584,4903,15848,2147,13701
"2011","Worcestershire","E10000034","Rural town and fringe",22083,8150,454,7696,5521,1905,5989,777,5212
"2011","Worcestershire","E10000034","Rural town and fringe in a sparse setting",0,0,0,0,0,0,0,0,0
"2011","Worcestershire","E10000034","Rural village",23419,7973,371,7602,5898,1788,5815,833,4982
"2011","Worcestershire","E10000034","Rural village in a sparse setting",0,0,0,0,0,0,0,0,0
"2011","Worcestershire","E10000034","Rural hamlet and isolated dwellings",17308,5219,225,4994,4165,1210,4044,537,3507
"2011","Worcestershire","E10000034","Rural hamlet and isolated dwellings in a sparse setting",0,0,0,0,0,0,0,0,0
"2011","Bedford","E06000055","Total",63812,19741,2467,17274,20128,7984,15437,3061,12376
"2011","Bedford","E06000055","Urban (total)",43768,13757,1990,11767,13799,5837,10852,2217,8635
"2011","Bedford","E06000055","Urban major conurbation",0,0,0,0,0,0,0,0,0
"2011","Bedford","E06000055","Urban minor conurbation",0,0,0,0,0,0,0,0,0
"2011","Bedford","E06000055","Urban city and town",43768,13757,1990,11767,13799,5837,10852,2217,8635
"2011","Bedford","E06000055","Urban city and town in a sparse setting",0,0,0,0,0,0,0,0,0
"2011","Bedford","E06000055","Rural (total)",20044,5984,477,5507,6329,2147,4585,844,3741
"2011","Bedford","E06000055","Rural town and fringe",10041,3067,272,2795,3420,1215,2378,484,1894
"2011","Bedford","E06000055","Rural town and fringe in a sparse setting",0,0,0,0,0,0,0,0,0
"2011","Bedford","E06000055","Rural village",6874,2026,158,1868,2055,683,1526,253,1273
"2011","Bedford","E06000055","Rural village in a sparse setting",0,0,0,0,0,0,0,0,0
"2011","Bedford","E06000055","Rural hamlet and isolated dwellings",3129,891,47,844,854,249,681,107,574
"2011","Bedford","E06000055","Rural hamlet and isolated dwellings in a sparse setting",0,0,0,0,0,0,0,0,0
"2011","Central Bedfordshire","E06000056","Total",104399,29068,3189,25879,32949,12565,23452,4529,18923
"2011","Central Bedfordshire","E06000056","Urban (total)",63701,17885,2389,15496,20564,8097,14525,2962,11563
"2011","Central Bedfordshire","E06000056","Urban major conurbation",0,0,0,0,0,0,0,0,0
"2011","Central Bedfordshire","E06000056","Urban minor conurbation",0,0,0,0,0,0,0,0,0
"2011","Central Bedfordshire","E06000056","Urban city and town",63701,17885,2389,15496,20564,8097,14525,2962,11563
"2011","Central Bedfordshire","E06000056","Urban city and town in a sparse setting",0,0,0,0,0,0,0,0,0
"2011","Central Bedfordshire","E06000056","Rural (total)",40698,11183,800,10383,12385,4468,8927,1567,7360
"2011","Central Bedfordshire","E06000056","Rural town and fringe",26363,7050,526,6524,8334,3117,5723,1081,4642
"2011","Central Bedfordshire","E06000056","Rural town and fringe in a sparse setting",0,0,0,0,0,0,0,0,0
"2011","Central Bedfordshire","E06000056","Rural village",10867,3154,232,2922,3127,1076,2402,361,2041
"2011","Central Bedfordshire","E06000056","Rural village in a sparse setting",0,0,0,0,0,0,0,0,0
"2011","Central Bedfordshire","E06000056","Rural hamlet and isolated dwellings",3468,979,42,937,924,275,802,125,677
"2011","Central Bedfordshire","E06000056","Rural hamlet and isolated dwellings in a sparse setting",0,0,0,0,0,0,0,0,0
"2011","Luton","E06000032","Total",74293,22639,4351,18288,26855,12587,17969,4700,13269
"2011","Luton","E06000032","Urban (total)",74293,22639,4351,18288,26855,12587,17969,4700,13269
"2011","Luton","E06000032","Urban major conurbation",0,0,0,0,0,0,0,0,0
"2011","Luton","E06000032","Urban minor conurbation",0,0,0,0,0,0,0,0,0
"2011","Luton","E06000032","Urban city and town",74293,22639,4351,18288,26855,12587,17969,4700,13269
"2011","Luton","E06000032","Urban city and town in a sparse setting",0,0,0,0,0,0,0,0,0
"2011","Luton","E06000032","Rural (total)",0,0,0,0,0,0,0,0,0
"2011","Luton","E06000032","Rural town and fringe",0,0,0,0,0,0,0,0,0
"2011","Luton","E06000032","Rural town and fringe in a sparse setting",0,0,0,0,0,0,0,0,0
"2011","Luton","E06000032","Rural village",0,0,0,0,0,0,0,0,0
"2011","Luton","E06000032","Rural village in a sparse setting",0,0,0,0,0,0,0,0,0
"2011","Luton","E06000032","Rural hamlet and isolated dwellings",0,0,0,0,0,0,0,0,0
"2011","Luton","E06000032","Rural hamlet and isolated dwellings in a sparse setting",0,0,0,0,0,0,0,0,0
"2011","Peterborough","E06000031","Total",74023,23218,3626,19592,24256,10883,18615,3985,14630
"2011","Peterborough","E06000031","Urban (total)",65301,20785,3427,17358,21514,9885,16692,3577,13115
"2011","Peterborough","E06000031","Urban major conurbation",0,0,0,0,0,0,0,0,0
"2011","Peterborough","E06000031","Urban minor conurbation",0,0,0,0,0,0,0,0,0
"2011","Peterborough","E06000031","Urban city and town",65301,20785,3427,17358,21514,9885,16692,3577,13115
"2011","Peterborough","E06000031","Urban city and town in a sparse setting",0,0,0,0,0,0,0,0,0
"2011","Peterborough","E06000031","Rural (total)",8722,2433,199,2234,2742,998,1923,408,1515
"2011","Peterborough","E06000031","Rural town and fringe",5378,1442,144,1298,1799,732,1188,261,927
"2011","Peterborough","E06000031","Rural town and fringe in a sparse setting",0,0,0,0,0,0,0,0,0
"2011","Peterborough","E06000031","Rural village",2703,857,45,812,760,209,585,115,470
"2011","Peterborough","E06000031","Rural village in a sparse setting",0,0,0,0,0,0,0,0,0
"2011","Peterborough","E06000031","Rural hamlet and isolated dwellings",641,134,10,124,183,57,150,32,118
"2011","Peterborough","E06000031","Rural hamlet and isolated dwellings in a sparse setting",0,0,0,0,0,0,0,0,0
"2011","Southend-on-Sea","E06000033","Total",74678,26008,3068,22940,21290,8815,19719,3285,16434
"2011","Southend-on-Sea","E06000033","Urban (total)",74678,26008,3068,22940,21290,8815,19719,3285,16434
"2011","Southend-on-Sea","E06000033","Urban major conurbation",0,0,0,0,0,0,0,0,0
"2011","Southend-on-Sea","E06000033","Urban minor conurbation",0,0,0,0,0,0,0,0,0
"2011","Southend-on-Sea","E06000033","Urban city and town",74678,26008,3068,22940,21290,8815,19719,3285,16434
"2011","Southend-on-Sea","E06000033","Urban city and town in a sparse setting",0,0,0,0,0,0,0,0,0
"2011","Southend-on-Sea","E06000033","Rural (total)",0,0,0,0,0,0,0,0,0
"2011","Southend-on-Sea","E06000033","Rural town and fringe",0,0,0,0,0,0,0,0,0
"2011","Southend-on-Sea","E06000033","Rural town and fringe in a sparse setting",0,0,0,0,0,0,0,0,0
"2011","Southend-on-Sea","E06000033","Rural village",0,0,0,0,0,0,0,0,0
"2011","Southend-on-Sea","E06000033","Rural village in a sparse setting",0,0,0,0,0,0,0,0,0
"2011","Southend-on-Sea","E06000033","Rural hamlet and isolated dwellings",0,0,0,0,0,0,0,0,0
"2011","Southend-on-Sea","E06000033","Rural hamlet and isolated dwellings in a sparse setting",0,0,0,0,0,0,0,0,0
"2011","Thurrock","E06000034","Total",62353,18215,3134,15081,21721,9467,15019,3239,11780
"2011","Thurrock","E06000034","Urban (total)",54549,16060,2848,13212,19137,8507,13167,2848,10319
"2011","Thurrock","E06000034","Urban major conurbation",41469,11890,2354,9536,15094,6916,9950,2262,7688
"2011","Thurrock","E06000034","Urban minor conurbation",0,0,0,0,0,0,0,0,0
"2011","Thurrock","E06000034","Urban city and town",13080,4170,494,3676,4043,1591,3217,586,2631
"2011","Thurrock","E06000034","Urban city and town in a sparse setting",0,0,0,0,0,0,0,0,0
"2011","Thurrock","E06000034","Rural (total)",7804,2155,286,1869,2584,960,1852,391,1461
"2011","Thurrock","E06000034","Rural town and fringe",6528,1866,267,1599,2195,825,1593,338,1255
"2011","Thurrock","E06000034","Rural town and fringe in a sparse setting",0,0,0,0,0,0,0,0,0
"2011","Thurrock","E06000034","Rural village",1038,233,15,218,327,116,213,45,168
"2011","Thurrock","E06000034","Rural village in a sparse setting",0,0,0,0,0,0,0,0,0
"2011","Thurrock","E06000034","Rural hamlet and isolated dwellings",238,56,4,52,62,19,46,8,38
"2011","Thurrock","E06000034","Rural hamlet and isolated dwellings in a sparse setting",0,0,0,0,0,0,0,0,0
"2011","Cambridgeshire","E10000003","Total",251241,72325,6164,66161,72352,28852,58424,9788,48636
"2011","Cambridgeshire","E10000003","Urban (total)",132886,40305,3892,36413,36243,15407,31473,5088,26385
"2011","Cambridgeshire","E10000003","Urban major conurbation",0,0,0,0,0,0,0,0,0
"2011","Cambridgeshire","E10000003","Urban minor conurbation",0,0,0,0,0,0,0,0,0
"2011","Cambridgeshire","E10000003","Urban city and town",132886,40305,3892,36413,36243,15407,31473,5088,26385
"2011","Cambridgeshire","E10000003","Urban city and town in a sparse setting",0,0,0,0,0,0,0,0,0
"2011","Cambridgeshire","E10000003","Rural (total)",118355,32020,2272,29748,36109,13445,26951,4700,22251
"2011","Cambridgeshire","E10000003","Rural town and fringe",72240,19487,1412,18075,22716,8881,16443,2902,13541
"2011","Cambridgeshire","E10000003","Rural town and fringe in a sparse setting",0,0,0,0,0,0,0,0,0
"2011","Cambridgeshire","E10000003","Rural village",35481,9877,644,9233,10230,3471,8101,1371,6730
"2011","Cambridgeshire","E10000003","Rural village in a sparse setting",0,0,0,0,0,0,0,0,0
"2011","Cambridgeshire","E10000003","Rural hamlet and isolated dwellings",10634,2656,216,2440,3163,1093,2407,427,1980
"2011","Cambridgeshire","E10000003","Rural hamlet and isolated dwellings in a sparse setting",0,0,0,0,0,0,0,0,0
"2011","Essex","E10000012","Total",581589,192641,19641,173000,169348,64617,145476,24364,121112
"2011","Essex","E10000012","Urban (total)",434076,144868,16455,128413,128117,50689,109210,18721,90489
"2011","Essex","E10000012","Urban major conurbation",30380,9327,1156,8171,9466,3750,7118,1196,5922
"2011","Essex","E10000012","Urban minor conurbation",0,0,0,0,0,0,0,0,0
"2011","Essex","E10000012","Urban city and town",403696,135541,15299,120242,118651,46939,102092,17525,84567
"2011","Essex","E10000012","Urban city and town in a sparse setting",0,0,0,0,0,0,0,0,0
"2011","Essex","E10000012","Rural (total)",147513,47773,3186,44587,41231,13928,36266,5643,30623
"2011","Essex","E10000012","Rural town and fringe",81694,28267,2040,26227,22772,8127,20905,3103,17802
"2011","Essex","E10000012","Rural town and fringe in a sparse setting",0,0,0,0,0,0,0,0,0
"2011","Essex","E10000012","Rural village",40595,12806,734,12072,11269,3596,9845,1556,8289
"2011","Essex","E10000012","Rural village in a sparse setting",0,0,0,0,0,0,0,0,0
"2011","Essex","E10000012","Rural hamlet and isolated dwellings",25224,6700,412,6288,7190,2205,5516,984,4532
"2011","Essex","E10000012","Rural hamlet and isolated dwellings in a sparse setting",0,0,0,0,0,0,0,0,0
"2011","Hertfordshire","E10000015","Total",453817,128455,14037,114418,144475,57816,101062,18930,82132
"2011","Hertfordshire","E10000015","Urban (total)",402649,114277,12989,101288,128645,52343,90155,17022,73133
"2011","Hertfordshire","E10000015","Urban major conurbation",166352,47122,6162,40960,53983,22333,38303,7413,30890
"2011","Hertfordshire","E10000015","Urban minor conurbation",0,0,0,0,0,0,0,0,0
"2011","Hertfordshire","E10000015","Urban city and town",236297,67155,6827,60328,74662,30010,51852,9609,42243
"2011","Hertfordshire","E10000015","Urban city and town in a sparse setting",0,0,0,0,0,0,0,0,0
"2011","Hertfordshire","E10000015","Rural (total)",51168,14178,1048,13130,15830,5473,10907,1908,8999
"2011","Hertfordshire","E10000015","Rural town and fringe",24151,6843,542,6301,7711,2888,5169,914,4255
"2011","Hertfordshire","E10000015","Rural town and fringe in a sparse setting",0,0,0,0,0,0,0,0,0
"2011","Hertfordshire","E10000015","Rural village",18968,5379,369,5010,5700,1857,4192,699,3493
"2011","Hertfordshire","E10000015","Rural village in a sparse setting",0,0,0,0,0,0,0,0,0
"2011","Hertfordshire","E10000015","Rural hamlet and isolated dwellings",8049,1956,137,1819,2419,728,1546,295,1251
"2011","Hertfordshire","E10000015","Rural hamlet and isolated dwellings in a sparse setting",0,0,0,0,0,0,0,0,0
"2011","Norfolk","E10000020","Total",372085,138644,12358,126286,94194,36584,100637,15075,85562
"2011","Norfolk","E10000020","Urban (total)",187375,68026,8127,59899,50043,20923,50036,8143,41893
"2011","Norfolk","E10000020","Urban major conurbation",0,0,0,0,0,0,0,0,0
"2011","Norfolk","E10000020","Urban minor conurbation",0,0,0,0,0,0,0,0,0
"2011","Norfolk","E10000020","Urban city and town",187375,68026,8127,59899,50043,20923,50036,8143,41893
"2011","Norfolk","E10000020","Urban city and town in a sparse setting",0,0,0,0,0,0,0,0,0
"2011","Norfolk","E10000020","Rural (total)",184710,70618,4231,66387,44151,15661,50601,6932,43669
"2011","Norfolk","E10000020","Rural town and fringe",69945,28589,1733,26856,16856,6303,19741,2566,17175
"2011","Norfolk","E10000020","Rural town and fringe in a sparse setting",10893,5367,232,5135,1957,712,3383,312,3071
"2011","Norfolk","E10000020","Rural village",65408,23853,1468,22385,15917,5501,17647,2575,15072
"2011","Norfolk","E10000020","Rural village in a sparse setting",6582,2800,145,2655,1233,462,1810,200,1610
"2011","Norfolk","E10000020","Rural hamlet and isolated dwellings",30176,9370,614,8756,7823,2559,7556,1216,6340
"2011","Norfolk","E10000020","Rural hamlet and isolated dwellings in a sparse setting",1706,639,39,600,365,124,464,63,401
"2011","Suffolk","E10000029","Total",310745,105938,9426,96512,85192,33368,79477,12692,66785
"2011","Suffolk","E10000029","Urban (total)",189732,64771,7116,57655,53820,22310,49189,8377,40812
"2011","Suffolk","E10000029","Urban major conurbation",0,0,0,0,0,0,0,0,0
"2011","Suffolk","E10000029","Urban minor conurbation",0,0,0,0,0,0,0,0,0
"2011","Suffolk","E10000029","Urban city and town",189732,64771,7116,57655,53820,22310,49189,8377,40812
"2011","Suffolk","E10000029","Urban city and town in a sparse setting",0,0,0,0,0,0,0,0,0
"2011","Suffolk","E10000029","Rural (total)",121013,41167,2310,38857,31372,11058,30288,4315,25973
"2011","Suffolk","E10000029","Rural town and fringe",46834,16934,1113,15821,12407,4749,12251,1725,10526
"2011","Suffolk","E10000029","Rural town and fringe in a sparse setting",3441,1392,96,1296,743,288,961,99,862
"2011","Suffolk","E10000029","Rural village",45471,15116,732,14384,11823,4031,11139,1632,9507
"2011","Suffolk","E10000029","Rural village in a sparse setting",129,62,0,62,11,6,36,0,36
"2011","Suffolk","E10000029","Rural hamlet and isolated dwellings",24602,7379,367,7012,6327,1964,5745,851,4894
"2011","Suffolk","E10000029","Rural hamlet and isolated dwellings in a sparse setting",536,284,2,282,61,20,156,8,148
"2011","Camden","E09000007","Total",97534,28654,4546,24108,21562,10355,21795,3916,17879
"2011","Camden","E09000007","Urban (total)",97534,28654,4546,24108,21562,10355,21795,3916,17879
"2011","Camden","E09000007","Urban major conurbation",97534,28654,4546,24108,21562,10355,21795,3916,17879
"2011","Camden","E09000007","Urban minor conurbation",0,0,0,0,0,0,0,0,0
"2011","Camden","E09000007","Urban city and town",0,0,0,0,0,0,0,0,0
"2011","Camden","E09000007","Urban city and town in a sparse setting",0,0,0,0,0,0,0,0,0
"2011","Camden","E09000007","Rural (total)",0,0,0,0,0,0,0,0,0
"2011","Camden","E09000007","Rural town and fringe",0,0,0,0,0,0,0,0,0
"2011","Camden","E09000007","Rural town and fringe in a sparse setting",0,0,0,0,0,0,0,0,0
"2011","Camden","E09000007","Rural village",0,0,0,0,0,0,0,0,0
"2011","Camden","E09000007","Rural village in a sparse setting",0,0,0,0,0,0,0,0,0
"2011","Camden","E09000007","Rural hamlet and isolated dwellings",0,0,0,0,0,0,0,0,0
"2011","Camden","E09000007","Rural hamlet and isolated dwellings in a sparse setting",0,0,0,0,0,0,0,0,0
"2011","City of London","E09000001","Total",4385,996,38,958,432,195,658,71,587
"2011","City of London","E09000001","Urban (total)",4385,996,38,958,432,195,658,71,587
"2011","City of London","E09000001","Urban major conurbation",4385,996,38,958,432,195,658,71,587
"2011","City of London","E09000001","Urban minor conurbation",0,0,0,0,0,0,0,0,0
"2011","City of London","E09000001","Urban city and town",0,0,0,0,0,0,0,0,0
"2011","City of London","E09000001","Urban city and town in a sparse setting",0,0,0,0,0,0,0,0,0
"2011","City of London","E09000001","Rural (total)",0,0,0,0,0,0,0,0,0
"2011","City of London","E09000001","Rural town and fringe",0,0,0,0,0,0,0,0,0
"2011","City of London","E09000001","Rural town and fringe in a sparse setting",0,0,0,0,0,0,0,0,0
"2011","City of London","E09000001","Rural village",0,0,0,0,0,0,0,0,0
"2011","City of London","E09000001","Rural village in a sparse setting",0,0,0,0,0,0,0,0,0
"2011","City of London","E09000001","Rural hamlet and isolated dwellings",0,0,0,0,0,0,0,0,0
"2011","City of London","E09000001","Rural hamlet and isolated dwellings in a sparse setting",0,0,0,0,0,0,0,0,0
"2011","Hackney","E09000012","Total",101690,29927,7689,22238,29106,14279,23783,5603,18180
"2011","Hackney","E09000012","Urban (total)",101431,29846,7662,22184,29018,14238,23720,5586,18134
"2011","Hackney","E09000012","Urban major conurbation",101431,29846,7662,22184,29018,14238,23720,5586,18134
"2011","Hackney","E09000012","Urban minor conurbation",0,0,0,0,0,0,0,0,0
"2011","Hackney","E09000012","Urban city and town",0,0,0,0,0,0,0,0,0
"2011","Hackney","E09000012","Urban city and town in a sparse setting",0,0,0,0,0,0,0,0,0
"2011","Hackney","E09000012","Rural (total)",259,81,27,54,88,41,63,17,46
"2011","Hackney","E09000012","Rural town and fringe",259,81,27,54,88,41,63,17,46
"2011","Hackney","E09000012","Rural town and fringe in a sparse setting",0,0,0,0,0,0,0,0,0
"2011","Hackney","E09000012","Rural village",0,0,0,0,0,0,0,0,0
"2011","Hackney","E09000012","Rural village in a sparse setting",0,0,0,0,0,0,0,0,0
"2011","Hackney","E09000012","Rural hamlet and isolated dwellings",0,0,0,0,0,0,0,0,0
"2011","Hackney","E09000012","Rural hamlet and isolated dwellings in a sparse setting",0,0,0,0,0,0,0,0,0
"2011","Hammersmith and Fulham","E09000013","Total",80590,21192,3897,17295,18479,9083,15999,2809,13190
"2011","Hammersmith and Fulham","E09000013","Urban (total)",80590,21192,3897,17295,18479,9083,15999,2809,13190
"2011","Hammersmith and Fulham","E09000013","Urban major conurbation",80590,21192,3897,17295,18479,9083,15999,2809,13190
"2011","Hammersmith and Fulham","E09000013","Urban minor conurbation",0,0,0,0,0,0,0,0,0
"2011","Hammersmith and Fulham","E09000013","Urban city and town",0,0,0,0,0,0,0,0,0
"2011","Hammersmith and Fulham","E09000013","Urban city and town in a sparse setting",0,0,0,0,0,0,0,0,0
"2011","Hammersmith and Fulham","E09000013","Rural (total)",0,0,0,0,0,0,0,0,0
"2011","Hammersmith and Fulham","E09000013","Rural town and fringe",0,0,0,0,0,0,0,0,0
"2011","Hammersmith and Fulham","E09000013","Rural town and fringe in a sparse setting",0,0,0,0,0,0,0,0,0
"2011","Hammersmith and Fulham","E09000013","Rural village",0,0,0,0,0,0,0,0,0
"2011","Hammersmith and Fulham","E09000013","Rural village in a sparse setting",0,0,0,0,0,0,0,0,0
"2011","Hammersmith and Fulham","E09000013","Rural hamlet and isolated dwellings",0,0,0,0,0,0,0,0,0
"2011","Hammersmith and Fulham","E09000013","Rural hamlet and isolated dwellings in a sparse setting",0,0,0,0,0,0,0,0,0
"2011","Haringey","E09000014","Total",101955,28563,7338,21225,31996,14240,23180,5611,17569
"2011","Haringey","E09000014","Urban (total)",101955,28563,7338,21225,31996,14240,23180,5611,17569
"2011","Haringey","E09000014","Urban major conurbation",101955,28563,7338,21225,31996,14240,23180,5611,17569
"2011","Haringey","E09000014","Urban minor conurbation",0,0,0,0,0,0,0,0,0
"2011","Haringey","E09000014","Urban city and town",0,0,0,0,0,0,0,0,0
"2011","Haringey","E09000014","Urban city and town in a sparse setting",0,0,0,0,0,0,0,0,0
"2011","Haringey","E09000014","Rural (total)",0,0,0,0,0,0,0,0,0
"2011","Haringey","E09000014","Rural town and fringe",0,0,0,0,0,0,0,0,0
"2011","Haringey","E09000014","Rural town and fringe in a sparse setting",0,0,0,0,0,0,0,0,0
"2011","Haringey","E09000014","Rural village",0,0,0,0,0,0,0,0,0
"2011","Haringey","E09000014","Rural village in a sparse setting",0,0,0,0,0,0,0,0,0
"2011","Haringey","E09000014","Rural hamlet and isolated dwellings",0,0,0,0,0,0,0,0,0
"2011","Haringey","E09000014","Rural hamlet and isolated dwellings in a sparse setting",0,0,0,0,0,0,0,0,0
"2011","Islington","E09000019","Total",93556,28245,6142,22103,20950,9651,22007,4260,17747
"2011","Islington","E09000019","Urban (total)",93556,28245,6142,22103,20950,9651,22007,4260,17747
"2011","Islington","E09000019","Urban major conurbation",93556,28245,6142,22103,20950,9651,22007,4260,17747
"2011","Islington","E09000019","Urban minor conurbation",0,0,0,0,0,0,0,0,0
"2011","Islington","E09000019","Urban city and town",0,0,0,0,0,0,0,0,0
"2011","Islington","E09000019","Urban city and town in a sparse setting",0,0,0,0,0,0,0,0,0
"2011","Islington","E09000019","Rural (total)",0,0,0,0,0,0,0,0,0
"2011","Islington","E09000019","Rural town and fringe",0,0,0,0,0,0,0,0,0
"2011","Islington","E09000019","Rural town and fringe in a sparse setting",0,0,0,0,0,0,0,0,0
"2011","Islington","E09000019","Rural village",0,0,0,0,0,0,0,0,0
"2011","Islington","E09000019","Rural village in a sparse setting",0,0,0,0,0,0,0,0,0
"2011","Islington","E09000019","Rural hamlet and isolated dwellings",0,0,0,0,0,0,0,0,0
"2011","Islington","E09000019","Rural hamlet and isolated dwellings in a sparse setting",0,0,0,0,0,0,0,0,0
"2011","Kensington and Chelsea","E09000020","Total",78536,22480,2842,19638,15300,7053,14091,2033,12058
"2011","Kensington and Chelsea","E09000020","Urban (total)",78536,22480,2842,19638,15300,7053,14091,2033,12058
"2011","Kensington and Chelsea","E09000020","Urban major conurbation",78536,22480,2842,19638,15300,7053,14091,2033,12058
"2011","Kensington and Chelsea","E09000020","Urban minor conurbation",0,0,0,0,0,0,0,0,0
"2011","Kensington and Chelsea","E09000020","Urban city and town",0,0,0,0,0,0,0,0,0
"2011","Kensington and Chelsea","E09000020","Urban city and town in a sparse setting",0,0,0,0,0,0,0,0,0
"2011","Kensington and Chelsea","E09000020","Rural (total)",0,0,0,0,0,0,0,0,0
"2011","Kensington and Chelsea","E09000020","Rural town and fringe",0,0,0,0,0,0,0,0,0
"2011","Kensington and Chelsea","E09000020","Rural town and fringe in a sparse setting",0,0,0,0,0,0,0,0,0
"2011","Kensington and Chelsea","E09000020","Rural village",0,0,0,0,0,0,0,0,0
"2011","Kensington and Chelsea","E09000020","Rural village in a sparse setting",0,0,0,0,0,0,0,0,0
"2011","Kensington and Chelsea","E09000020","Rural hamlet and isolated dwellings",0,0,0,0,0,0,0,0,0
"2011","Kensington and Chelsea","E09000020","Rural hamlet and isolated dwellings in a sparse setting",0,0,0,0,0,0,0,0,0
"2011","Lambeth","E09000022","Total",130017,32798,7945,24853,34861,16340,26513,5685,20828
"2011","Lambeth","E09000022","Urban (total)",130017,32798,7945,24853,34861,16340,26513,5685,20828
"2011","Lambeth","E09000022","Urban major conurbation",130017,32798,7945,24853,34861,16340,26513,5685,20828
"2011","Lambeth","E09000022","Urban minor conurbation",0,0,0,0,0,0,0,0,0
"2011","Lambeth","E09000022","Urban city and town",0,0,0,0,0,0,0,0,0
"2011","Lambeth","E09000022","Urban city and town in a sparse setting",0,0,0,0,0,0,0,0,0
"2011","Lambeth","E09000022","Rural (total)",0,0,0,0,0,0,0,0,0
"2011","Lambeth","E09000022","Rural town and fringe",0,0,0,0,0,0,0,0,0
"2011","Lambeth","E09000022","Rural town and fringe in a sparse setting",0,0,0,0,0,0,0,0,0
"2011","Lambeth","E09000022","Rural village",0,0,0,0,0,0,0,0,0
"2011","Lambeth","E09000022","Rural village in a sparse setting",0,0,0,0,0,0,0,0,0
"2011","Lambeth","E09000022","Rural hamlet and isolated dwellings",0,0,0,0,0,0,0,0,0
"2011","Lambeth","E09000022","Rural hamlet and isolated dwellings in a sparse setting",0,0,0,0,0,0,0,0,0
"2011","Lewisham","E09000023","Total",116091,32562,7599,24963,36923,17298,26399,5953,20446
"2011","Lewisham","E09000023","Urban (total)",116091,32562,7599,24963,36923,17298,26399,5953,20446
"2011","Lewisham","E09000023","Urban major conurbation",116091,32562,7599,24963,36923,17298,26399,5953,20446
"2011","Lewisham","E09000023","Urban minor conurbation",0,0,0,0,0,0,0,0,0
"2011","Lewisham","E09000023","Urban city and town",0,0,0,0,0,0,0,0,0
"2011","Lewisham","E09000023","Urban city and town in a sparse setting",0,0,0,0,0,0,0,0,0
"2011","Lewisham","E09000023","Rural (total)",0,0,0,0,0,0,0,0,0
"2011","Lewisham","E09000023","Rural town and fringe",0,0,0,0,0,0,0,0,0
"2011","Lewisham","E09000023","Rural town and fringe in a sparse setting",0,0,0,0,0,0,0,0,0
"2011","Lewisham","E09000023","Rural village",0,0,0,0,0,0,0,0,0
"2011","Lewisham","E09000023","Rural village in a sparse setting",0,0,0,0,0,0,0,0,0
"2011","Lewisham","E09000023","Rural hamlet and isolated dwellings",0,0,0,0,0,0,0,0,0
"2011","Lewisham","E09000023","Rural hamlet and isolated dwellings in a sparse setting",0,0,0,0,0,0,0,0,0
"2011","Newham","E09000025","Total",101519,28719,8262,20457,39831,19431,24470,7594,16876
"2011","Newham","E09000025","Urban (total)",101519,28719,8262,20457,39831,19431,24470,7594,16876
"2011","Newham","E09000025","Urban major conurbation",101519,28719,8262,20457,39831,19431,24470,7594,16876
"2011","Newham","E09000025","Urban minor conurbation",0,0,0,0,0,0,0,0,0
"2011","Newham","E09000025","Urban city and town",0,0,0,0,0,0,0,0,0
"2011","Newham","E09000025","Urban city and town in a sparse setting",0,0,0,0,0,0,0,0,0
"2011","Newham","E09000025","Rural (total)",0,0,0,0,0,0,0,0,0
"2011","Newham","E09000025","Rural town and fringe",0,0,0,0,0,0,0,0,0
"2011","Newham","E09000025","Rural town and fringe in a sparse setting",0,0,0,0,0,0,0,0,0
"2011","Newham","E09000025","Rural village",0,0,0,0,0,0,0,0,0
"2011","Newham","E09000025","Rural village in a sparse setting",0,0,0,0,0,0,0,0,0
"2011","Newham","E09000025","Rural hamlet and isolated dwellings",0,0,0,0,0,0,0,0,0
"2011","Newham","E09000025","Rural hamlet and isolated dwellings in a sparse setting",0,0,0,0,0,0,0,0,0
"2011","Southwark","E09000028","Total",120422,32071,7420,24651,34054,16341,26418,5870,20548
"2011","Southwark","E09000028","Urban (total)",120422,32071,7420,24651,34054,16341,26418,5870,20548
"2011","Southwark","E09000028","Urban major conurbation",120422,32071,7420,24651,34054,16341,26418,5870,20548
"2011","Southwark","E09000028","Urban minor conurbation",0,0,0,0,0,0,0,0,0
"2011","Southwark","E09000028","Urban city and town",0,0,0,0,0,0,0,0,0
"2011","Southwark","E09000028","Urban city and town in a sparse setting",0,0,0,0,0,0,0,0,0
"2011","Southwark","E09000028","Rural (total)",0,0,0,0,0,0,0,0,0
"2011","Southwark","E09000028","Rural town and fringe",0,0,0,0,0,0,0,0,0
"2011","Southwark","E09000028","Rural town and fringe in a sparse setting",0,0,0,0,0,0,0,0,0
"2011","Southwark","E09000028","Rural village",0,0,0,0,0,0,0,0,0
"2011","Southwark","E09000028","Rural village in a sparse setting",0,0,0,0,0,0,0,0,0
"2011","Southwark","E09000028","Rural hamlet and isolated dwellings",0,0,0,0,0,0,0,0,0
"2011","Southwark","E09000028","Rural hamlet and isolated dwellings in a sparse setting",0,0,0,0,0,0,0,0,0
"2011","Tower Hamlets","E09000030","Total",101257,27323,7795,19528,26928,14669,20840,5742,15098
"2011","Tower Hamlets","E09000030","Urban (total)",101257,27323,7795,19528,26928,14669,20840,5742,15098
"2011","Tower Hamlets","E09000030","Urban major conurbation",101257,27323,7795,19528,26928,14669,20840,5742,15098
"2011","Tower Hamlets","E09000030","Urban minor conurbation",0,0,0,0,0,0,0,0,0
"2011","Tower Hamlets","E09000030","Urban city and town",0,0,0,0,0,0,0,0,0
"2011","Tower Hamlets","E09000030","Urban city and town in a sparse setting",0,0,0,0,0,0,0,0,0
"2011","Tower Hamlets","E09000030","Rural (total)",0,0,0,0,0,0,0,0,0
"2011","Tower Hamlets","E09000030","Rural town and fringe",0,0,0,0,0,0,0,0,0
"2011","Tower Hamlets","E09000030","Rural town and fringe in a sparse setting",0,0,0,0,0,0,0,0,0
"2011","Tower Hamlets","E09000030","Rural village",0,0,0,0,0,0,0,0,0
"2011","Tower Hamlets","E09000030","Rural village in a sparse setting",0,0,0,0,0,0,0,0,0
"2011","Tower Hamlets","E09000030","Rural hamlet and isolated dwellings",0,0,0,0,0,0,0,0,0
"2011","Tower Hamlets","E09000030","Rural hamlet and isolated dwellings in a sparse setting",0,0,0,0,0,0,0,0,0
"2011","Wandsworth","E09000032","Total",130493,27840,5027,22813,31665,16474,22453,4276,18177
"2011","Wandsworth","E09000032","Urban (total)",130493,27840,5027,22813,31665,16474,22453,4276,18177
"2011","Wandsworth","E09000032","Urban major conurbation",130493,27840,5027,22813,31665,16474,22453,4276,18177
"2011","Wandsworth","E09000032","Urban minor conurbation",0,0,0,0,0,0,0,0,0
"2011","Wandsworth","E09000032","Urban city and town",0,0,0,0,0,0,0,0,0
"2011","Wandsworth","E09000032","Urban city and town in a sparse setting",0,0,0,0,0,0,0,0,0
"2011","Wandsworth","E09000032","Rural (total)",0,0,0,0,0,0,0,0,0
"2011","Wandsworth","E09000032","Rural town and fringe",0,0,0,0,0,0,0,0,0
"2011","Wandsworth","E09000032","Rural town and fringe in a sparse setting",0,0,0,0,0,0,0,0,0
"2011","Wandsworth","E09000032","Rural village",0,0,0,0,0,0,0,0,0
"2011","Wandsworth","E09000032","Rural village in a sparse setting",0,0,0,0,0,0,0,0,0
"2011","Wandsworth","E09000032","Rural hamlet and isolated dwellings",0,0,0,0,0,0,0,0,0
"2011","Wandsworth","E09000032","Rural hamlet and isolated dwellings in a sparse setting",0,0,0,0,0,0,0,0,0
"2011","Westminster","E09000033","Total",105772,32036,5251,26785,20123,9806,21380,3726,17654
"2011","Westminster","E09000033","Urban (total)",105772,32036,5251,26785,20123,9806,21380,3726,17654
"2011","Westminster","E09000033","Urban major conurbation",105772,32036,5251,26785,20123,9806,21380,3726,17654
"2011","Westminster","E09000033","Urban minor conurbation",0,0,0,0,0,0,0,0,0
"2011","Westminster","E09000033","Urban city and town",0,0,0,0,0,0,0,0,0
"2011","Westminster","E09000033","Urban city and town in a sparse setting",0,0,0,0,0,0,0,0,0
"2011","Westminster","E09000033","Rural (total)",0,0,0,0,0,0,0,0,0
"2011","Westminster","E09000033","Rural town and fringe",0,0,0,0,0,0,0,0,0
"2011","Westminster","E09000033","Rural town and fringe in a sparse setting",0,0,0,0,0,0,0,0,0
"2011","Westminster","E09000033","Rural village",0,0,0,0,0,0,0,0,0
"2011","Westminster","E09000033","Rural village in a sparse setting",0,0,0,0,0,0,0,0,0
"2011","Westminster","E09000033","Rural hamlet and isolated dwellings",0,0,0,0,0,0,0,0,0
"2011","Westminster","E09000033","Rural hamlet and isolated dwellings in a sparse setting",0,0,0,0,0,0,0,0,0
"2011","Barking and Dagenham","E09000002","Total",69681,24547,7279,17268,28946,14311,18751,4994,13757
"2011","Barking and Dagenham","E09000002","Urban (total)",69681,24547,7279,17268,28946,14311,18751,4994,13757
"2011","Barking and Dagenham","E09000002","Urban major conurbation",69681,24547,7279,17268,28946,14311,18751,4994,13757
"2011","Barking and Dagenham","E09000002","Urban minor conurbation",0,0,0,0,0,0,0,0,0
"2011","Barking and Dagenham","E09000002","Urban city and town",0,0,0,0,0,0,0,0,0
"2011","Barking and Dagenham","E09000002","Urban city and town in a sparse setting",0,0,0,0,0,0,0,0,0
"2011","Barking and Dagenham","E09000002","Rural (total)",0,0,0,0,0,0,0,0,0
"2011","Barking and Dagenham","E09000002","Rural town and fringe",0,0,0,0,0,0,0,0,0
"2011","Barking and Dagenham","E09000002","Rural town and fringe in a sparse setting",0,0,0,0,0,0,0,0,0
"2011","Barking and Dagenham","E09000002","Rural village",0,0,0,0,0,0,0,0,0
"2011","Barking and Dagenham","E09000002","Rural village in a sparse setting",0,0,0,0,0,0,0,0,0
"2011","Barking and Dagenham","E09000002","Rural hamlet and isolated dwellings",0,0,0,0,0,0,0,0,0
"2011","Barking and Dagenham","E09000002","Rural hamlet and isolated dwellings in a sparse setting",0,0,0,0,0,0,0,0,0
"2011","Barnet","E09000003","Total",135916,37469,6596,30873,45528,19963,30924,6690,24234
"2011","Barnet","E09000003","Urban (total)",135916,37469,6596,30873,45528,19963,30924,6690,24234
"2011","Barnet","E09000003","Urban major conurbation",135654,37408,6589,30819,45433,19935,30877,6680,24197
"2011","Barnet","E09000003","Urban minor conurbation",0,0,0,0,0,0,0,0,0
"2011","Barnet","E09000003","Urban city and town",262,61,7,54,95,28,47,10,37
"2011","Barnet","E09000003","Urban city and town in a sparse setting",0,0,0,0,0,0,0,0,0
"2011","Barnet","E09000003","Rural (total)",0,0,0,0,0,0,0,0,0
"2011","Barnet","E09000003","Rural town and fringe",0,0,0,0,0,0,0,0,0
"2011","Barnet","E09000003","Rural town and fringe in a sparse setting",0,0,0,0,0,0,0,0,0
"2011","Barnet","E09000003","Rural village",0,0,0,0,0,0,0,0,0
"2011","Barnet","E09000003","Rural village in a sparse setting",0,0,0,0,0,0,0,0,0
"2011","Barnet","E09000003","Rural hamlet and isolated dwellings",0,0,0,0,0,0,0,0,0
"2011","Barnet","E09000003","Rural hamlet and isolated dwellings in a sparse setting",0,0,0,0,0,0,0,0,0
"2011","Bexley","E09000004","Total",92604,29834,4162,25672,30688,12053,22750,4427,18323
"2011","Bexley","E09000004","Urban (total)",92544,29816,4162,25654,30676,12050,22736,4426,18310
"2011","Bexley","E09000004","Urban major conurbation",92544,29816,4162,25654,30676,12050,22736,4426,18310
"2011","Bexley","E09000004","Urban minor conurbation",0,0,0,0,0,0,0,0,0
"2011","Bexley","E09000004","Urban city and town",0,0,0,0,0,0,0,0,0
"2011","Bexley","E09000004","Urban city and town in a sparse setting",0,0,0,0,0,0,0,0,0
"2011","Bexley","E09000004","Rural (total)",60,18,0,18,12,3,14,1,13
"2011","Bexley","E09000004","Rural town and fringe",0,0,0,0,0,0,0,0,0
"2011","Bexley","E09000004","Rural town and fringe in a sparse setting",0,0,0,0,0,0,0,0,0
"2011","Bexley","E09000004","Rural village",0,0,0,0,0,0,0,0,0
"2011","Bexley","E09000004","Rural village in a sparse setting",0,0,0,0,0,0,0,0,0
"2011","Bexley","E09000004","Rural hamlet and isolated dwellings",60,18,0,18,12,3,14,1,13
"2011","Bexley","E09000004","Rural hamlet and isolated dwellings in a sparse setting",0,0,0,0,0,0,0,0,0
"2011","Brent","E09000005","Total",110286,29849,6876,22973,37912,17180,26502,6789,19713
"2011","Brent","E09000005","Urban (total)",110286,29849,6876,22973,37912,17180,26502,6789,19713
"2011","Brent","E09000005","Urban major conurbation",110286,29849,6876,22973,37912,17180,26502,6789,19713
"2011","Brent","E09000005","Urban minor conurbation",0,0,0,0,0,0,0,0,0
"2011","Brent","E09000005","Urban city and town",0,0,0,0,0,0,0,0,0
"2011","Brent","E09000005","Urban city and town in a sparse setting",0,0,0,0,0,0,0,0,0
"2011","Brent","E09000005","Rural (total)",0,0,0,0,0,0,0,0,0
"2011","Brent","E09000005","Rural town and fringe",0,0,0,0,0,0,0,0,0
"2011","Brent","E09000005","Rural town and fringe in a sparse setting",0,0,0,0,0,0,0,0,0
"2011","Brent","E09000005","Rural village",0,0,0,0,0,0,0,0,0
"2011","Brent","E09000005","Rural village in a sparse setting",0,0,0,0,0,0,0,0,0
"2011","Brent","E09000005","Rural hamlet and isolated dwellings",0,0,0,0,0,0,0,0,0
"2011","Brent","E09000005","Rural hamlet and isolated dwellings in a sparse setting",0,0,0,0,0,0,0,0,0
"2011","Bromley","E09000006","Total",130862,40893,4910,35983,39751,15848,29772,5363,24409
"2011","Bromley","E09000006","Urban (total)",129376,40386,4887,35499,39414,15731,29414,5316,24098
"2011","Bromley","E09000006","Urban major conurbation",123772,38868,4761,34107,37674,15088,28208,5100,23108
"2011","Bromley","E09000006","Urban minor conurbation",0,0,0,0,0,0,0,0,0
"2011","Bromley","E09000006","Urban city and town",5604,1518,126,1392,1740,643,1206,216,990
"2011","Bromley","E09000006","Urban city and town in a sparse setting",0,0,0,0,0,0,0,0,0
"2011","Bromley","E09000006","Rural (total)",1486,507,23,484,337,117,358,47,311
"2011","Bromley","E09000006","Rural town and fringe",253,94,6,88,60,31,63,6,57
"2011","Bromley","E09000006","Rural town and fringe in a sparse setting",0,0,0,0,0,0,0,0,0
"2011","Bromley","E09000006","Rural village",751,258,13,245,168,55,181,22,159
"2011","Bromley","E09000006","Rural village in a sparse setting",0,0,0,0,0,0,0,0,0
"2011","Bromley","E09000006","Rural hamlet and isolated dwellings",482,155,4,151,109,31,114,19,95
"2011","Bromley","E09000006","Rural hamlet and isolated dwellings in a sparse setting",0,0,0,0,0,0,0,0,0
"2011","Croydon","E09000008","Total",145010,41516,9271,32245,51060,22233,33106,8000,25106
"2011","Croydon","E09000008","Urban (total)",145010,41516,9271,32245,51060,22233,33106,8000,25106
"2011","Croydon","E09000008","Urban major conurbation",145010,41516,9271,32245,51060,22233,33106,8000,25106
"2011","Croydon","E09000008","Urban minor conurbation",0,0,0,0,0,0,0,0,0
"2011","Croydon","E09000008","Urban city and town",0,0,0,0,0,0,0,0,0
"2011","Croydon","E09000008","Urban city and town in a sparse setting",0,0,0,0,0,0,0,0,0
"2011","Croydon","E09000008","Rural (total)",0,0,0,0,0,0,0,0,0
"2011","Croydon","E09000008","Rural town and fringe",0,0,0,0,0,0,0,0,0
"2011","Croydon","E09000008","Rural town and fringe in a sparse setting",0,0,0,0,0,0,0,0,0
"2011","Croydon","E09000008","Rural village",0,0,0,0,0,0,0,0,0
"2011","Croydon","E09000008","Rural village in a sparse setting",0,0,0,0,0,0,0,0,0
"2011","Croydon","E09000008","Rural hamlet and isolated dwellings",0,0,0,0,0,0,0,0,0
"2011","Croydon","E09000008","Rural hamlet and isolated dwellings in a sparse setting",0,0,0,0,0,0,0,0,0
"2011","Ealing","E09000009","Total",124082,32891,6991,25900,42037,19507,28320,6769,21551
"2011","Ealing","E09000009","Urban (total)",124082,32891,6991,25900,42037,19507,28320,6769,21551
"2011","Ealing","E09000009","Urban major conurbation",124082,32891,6991,25900,42037,19507,28320,6769,21551
"2011","Ealing","E09000009","Urban minor conurbation",0,0,0,0,0,0,0,0,0
"2011","Ealing","E09000009","Urban city and town",0,0,0,0,0,0,0,0,0
"2011","Ealing","E09000009","Urban city and town in a sparse setting",0,0,0,0,0,0,0,0,0
"2011","Ealing","E09000009","Rural (total)",0,0,0,0,0,0,0,0,0
"2011","Ealing","E09000009","Rural town and fringe",0,0,0,0,0,0,0,0,0
"2011","Ealing","E09000009","Rural town and fringe in a sparse setting",0,0,0,0,0,0,0,0,0
"2011","Ealing","E09000009","Rural village",0,0,0,0,0,0,0,0,0
"2011","Ealing","E09000009","Rural village in a sparse setting",0,0,0,0,0,0,0,0,0
"2011","Ealing","E09000009","Rural hamlet and isolated dwellings",0,0,0,0,0,0,0,0,0
"2011","Ealing","E09000009","Rural hamlet and isolated dwellings in a sparse setting",0,0,0,0,0,0,0,0,0
"2011","Enfield","E09000010","Total",119916,38761,10169,28592,44063,19042,29312,7318,21994
"2011","Enfield","E09000010","Urban (total)",119440,38625,10162,28463,43934,19005,29200,7304,21896
"2011","Enfield","E09000010","Urban major conurbation",118832,38464,10151,28313,43698,18925,29087,7278,21809
"2011","Enfield","E09000010","Urban minor conurbation",0,0,0,0,0,0,0,0,0
"2011","Enfield","E09000010","Urban city and town",608,161,11,150,236,80,113,26,87
"2011","Enfield","E09000010","Urban city and town in a sparse setting",0,0,0,0,0,0,0,0,0
"2011","Enfield","E09000010","Rural (total)",476,136,7,129,129,37,112,14,98
"2011","Enfield","E09000010","Rural town and fringe",0,0,0,0,0,0,0,0,0
"2011","Enfield","E09000010","Rural town and fringe in a sparse setting",0,0,0,0,0,0,0,0,0
"2011","Enfield","E09000010","Rural village",320,102,4,98,80,23,81,9,72
"2011","Enfield","E09000010","Rural village in a sparse setting",0,0,0,0,0,0,0,0,0
"2011","Enfield","E09000010","Rural hamlet and isolated dwellings",156,34,3,31,49,14,31,5,26
"2011","Enfield","E09000010","Rural hamlet and isolated dwellings in a sparse setting",0,0,0,0,0,0,0,0,0
"2011","Greenwich","E09000011","Total",101045,30676,7130,23546,33989,16241,24422,5746,18676
"2011","Greenwich","E09000011","Urban (total)",101045,30676,7130,23546,33989,16241,24422,5746,18676
"2011","Greenwich","E09000011","Urban major conurbation",101045,30676,7130,23546,33989,16241,24422,5746,18676
"2011","Greenwich","E09000011","Urban minor conurbation",0,0,0,0,0,0,0,0,0
"2011","Greenwich","E09000011","Urban city and town",0,0,0,0,0,0,0,0,0
"2011","Greenwich","E09000011","Urban city and town in a sparse setting",0,0,0,0,0,0,0,0,0
"2011","Greenwich","E09000011","Rural (total)",0,0,0,0,0,0,0,0,0
"2011","Greenwich","E09000011","Rural town and fringe",0,0,0,0,0,0,0,0,0
"2011","Greenwich","E09000011","Rural town and fringe in a sparse setting",0,0,0,0,0,0,0,0,0
"2011","Greenwich","E09000011","Rural village",0,0,0,0,0,0,0,0,0
"2011","Greenwich","E09000011","Rural village in a sparse setting",0,0,0,0,0,0,0,0,0
"2011","Greenwich","E09000011","Rural hamlet and isolated dwellings",0,0,0,0,0,0,0,0,0
"2011","Greenwich","E09000011","Rural hamlet and isolated dwellings in a sparse setting",0,0,0,0,0,0,0,0,0
"2011","Harrow","E09000015","Total",84268,22463,3675,18788,30670,12435,20323,5038,15285
"2011","Harrow","E09000015","Urban (total)",84027,22421,3661,18760,30593,12394,20286,5025,15261
"2011","Harrow","E09000015","Urban major conurbation",84027,22421,3661,18760,30593,12394,20286,5025,15261
"2011","Harrow","E09000015","Urban minor conurbation",0,0,0,0,0,0,0,0,0
"2011","Harrow","E09000015","Urban city and town",0,0,0,0,0,0,0,0,0
"2011","Harrow","E09000015","Urban city and town in a sparse setting",0,0,0,0,0,0,0,0,0
"2011","Harrow","E09000015","Rural (total)",241,42,14,28,77,41,37,13,24
"2011","Harrow","E09000015","Rural town and fringe",0,0,0,0,0,0,0,0,0
"2011","Harrow","E09000015","Rural town and fringe in a sparse setting",0,0,0,0,0,0,0,0,0
"2011","Harrow","E09000015","Rural village",241,42,14,28,77,41,37,13,24
"2011","Harrow","E09000015","Rural village in a sparse setting",0,0,0,0,0,0,0,0,0
"2011","Harrow","E09000015","Rural hamlet and isolated dwellings",0,0,0,0,0,0,0,0,0
"2011","Harrow","E09000015","Rural hamlet and isolated dwellings in a sparse setting",0,0,0,0,0,0,0,0,0
"2011","Havering","E09000016","Total",97199,33252,4070,29182,29242,10981,25111,4167,20944
"2011","Havering","E09000016","Urban (total)",96438,32963,4058,28905,29080,10932,24903,4140,20763
"2011","Havering","E09000016","Urban major conurbation",96186,32884,4050,28834,29006,10908,24838,4126,20712
"2011","Havering","E09000016","Urban minor conurbation",0,0,0,0,0,0,0,0,0
"2011","Havering","E09000016","Urban city and town",252,79,8,71,74,24,65,14,51
"2011","Havering","E09000016","Urban city and town in a sparse setting",0,0,0,0,0,0,0,0,0
"2011","Havering","E09000016","Rural (total)",761,289,12,277,162,49,208,27,181
"2011","Havering","E09000016","Rural town and fringe",246,135,4,131,36,10,69,4,65
"2011","Havering","E09000016","Rural town and fringe in a sparse setting",0,0,0,0,0,0,0,0,0
"2011","Havering","E09000016","Rural village",116,34,2,32,28,13,34,5,29
"2011","Havering","E09000016","Rural village in a sparse setting",0,0,0,0,0,0,0,0,0
"2011","Havering","E09000016","Rural hamlet and isolated dwellings",399,120,6,114,98,26,105,18,87
"2011","Havering","E09000016","Rural hamlet and isolated dwellings in a sparse setting",0,0,0,0,0,0,0,0,0
"2011","Hillingdon","E09000017","Total",100214,28742,5310,23432,35895,15330,23913,5828,18085
"2011","Hillingdon","E09000017","Urban (total)",97206,27829,5199,22630,34989,14942,23179,5686,17493
"2011","Hillingdon","E09000017","Urban major conurbation",96098,27564,5148,22416,34695,14816,22941,5636,17305
"2011","Hillingdon","E09000017","Urban minor conurbation",0,0,0,0,0,0,0,0,0
"2011","Hillingdon","E09000017","Urban city and town",1108,265,51,214,294,126,238,50,188
"2011","Hillingdon","E09000017","Urban city and town in a sparse setting",0,0,0,0,0,0,0,0,0
"2011","Hillingdon","E09000017","Rural (total)",3008,913,111,802,906,388,734,142,592
"2011","Hillingdon","E09000017","Rural town and fringe",2639,841,104,737,782,345,660,120,540
"2011","Hillingdon","E09000017","Rural town and fringe in a sparse setting",0,0,0,0,0,0,0,0,0
"2011","Hillingdon","E09000017","Rural village",318,61,7,54,113,41,61,20,41
"2011","Hillingdon","E09000017","Rural village in a sparse setting",0,0,0,0,0,0,0,0,0
"2011","Hillingdon","E09000017","Rural hamlet and isolated dwellings",51,11,0,11,11,2,13,2,11
"2011","Hillingdon","E09000017","Rural hamlet and isolated dwellings in a sparse setting",0,0,0,0,0,0,0,0,0
"2011","Hounslow","E09000018","Total",94902,24373,5252,19121,32763,15539,21365,5245,16120
"2011","Hounslow","E09000018","Urban (total)",94902,24373,5252,19121,32763,15539,21365,5245,16120
"2011","Hounslow","E09000018","Urban major conurbation",94902,24373,5252,19121,32763,15539,21365,5245,16120
"2011","Hounslow","E09000018","Urban minor conurbation",0,0,0,0,0,0,0,0,0
"2011","Hounslow","E09000018","Urban city and town",0,0,0,0,0,0,0,0,0
"2011","Hounslow","E09000018","Urban city and town in a sparse setting",0,0,0,0,0,0,0,0,0
"2011","Hounslow","E09000018","Rural (total)",0,0,0,0,0,0,0,0,0
"2011","Hounslow","E09000018","Rural town and fringe",0,0,0,0,0,0,0,0,0
"2011","Hounslow","E09000018","Rural town and fringe in a sparse setting",0,0,0,0,0,0,0,0,0
"2011","Hounslow","E09000018","Rural village",0,0,0,0,0,0,0,0,0
"2011","Hounslow","E09000018","Rural village in a sparse setting",0,0,0,0,0,0,0,0,0
"2011","Hounslow","E09000018","Rural hamlet and isolated dwellings",0,0,0,0,0,0,0,0,0
"2011","Hounslow","E09000018","Rural hamlet and isolated dwellings in a sparse setting",0,0,0,0,0,0,0,0,0
"2011","Kingston upon Thames","E09000021","Total",63639,16440,1949,14491,19690,8610,12719,2490,10229
"2011","Kingston upon Thames","E09000021","Urban (total)",63477,16403,1945,14458,19636,8593,12686,2485,10201
"2011","Kingston upon Thames","E09000021","Urban major conurbation",62646,16179,1920,14259,19351,8495,12498,2445,10053
"2011","Kingston upon Thames","E09000021","Urban minor conurbation",0,0,0,0,0,0,0,0,0
"2011","Kingston upon Thames","E09000021","Urban city and town",831,224,25,199,285,98,188,40,148
"2011","Kingston upon Thames","E09000021","Urban city and town in a sparse setting",0,0,0,0,0,0,0,0,0
"2011","Kingston upon Thames","E09000021","Rural (total)",162,37,4,33,54,17,33,5,28
"2011","Kingston upon Thames","E09000021","Rural town and fringe",0,0,0,0,0,0,0,0,0
"2011","Kingston upon Thames","E09000021","Rural town and fringe in a sparse setting",0,0,0,0,0,0,0,0,0
"2011","Kingston upon Thames","E09000021","Rural village",162,37,4,33,54,17,33,5,28
"2011","Kingston upon Thames","E09000021","Rural village in a sparse setting",0,0,0,0,0,0,0,0,0
"2011","Kingston upon Thames","E09000021","Rural hamlet and isolated dwellings",0,0,0,0,0,0,0,0,0
"2011","Kingston upon Thames","E09000021","Rural hamlet and isolated dwellings in a sparse setting",0,0,0,0,0,0,0,0,0
"2011","Merton","E09000024","Total",78757,18817,2842,15975,24894,11509,15748,3302,12446
"2011","Merton","E09000024","Urban (total)",78757,18817,2842,15975,24894,11509,15748,3302,12446
"2011","Merton","E09000024","Urban major conurbation",78757,18817,2842,15975,24894,11509,15748,3302,12446
"2011","Merton","E09000024","Urban minor conurbation",0,0,0,0,0,0,0,0,0
"2011","Merton","E09000024","Urban city and town",0,0,0,0,0,0,0,0,0
"2011","Merton","E09000024","Urban city and town in a sparse setting",0,0,0,0,0,0,0,0,0
"2011","Merton","E09000024","Rural (total)",0,0,0,0,0,0,0,0,0
"2011","Merton","E09000024","Rural town and fringe",0,0,0,0,0,0,0,0,0
"2011","Merton","E09000024","Rural town and fringe in a sparse setting",0,0,0,0,0,0,0,0,0
"2011","Merton","E09000024","Rural village",0,0,0,0,0,0,0,0,0
"2011","Merton","E09000024","Rural village in a sparse setting",0,0,0,0,0,0,0,0,0
"2011","Merton","E09000024","Rural hamlet and isolated dwellings",0,0,0,0,0,0,0,0,0
"2011","Merton","E09000024","Rural hamlet and isolated dwellings in a sparse setting",0,0,0,0,0,0,0,0,0
"2011","Redbridge","E09000026","Total",99105,27955,5895,22060,38176,16942,24104,6491,17613
"2011","Redbridge","E09000026","Urban (total)",99105,27955,5895,22060,38176,16942,24104,6491,17613
"2011","Redbridge","E09000026","Urban major conurbation",99105,27955,5895,22060,38176,16942,24104,6491,17613
"2011","Redbridge","E09000026","Urban minor conurbation",0,0,0,0,0,0,0,0,0
"2011","Redbridge","E09000026","Urban city and town",0,0,0,0,0,0,0,0,0
"2011","Redbridge","E09000026","Urban city and town in a sparse setting",0,0,0,0,0,0,0,0,0
"2011","Redbridge","E09000026","Rural (total)",0,0,0,0,0,0,0,0,0
"2011","Redbridge","E09000026","Rural town and fringe",0,0,0,0,0,0,0,0,0
"2011","Redbridge","E09000026","Rural town and fringe in a sparse setting",0,0,0,0,0,0,0,0,0
"2011","Redbridge","E09000026","Rural village",0,0,0,0,0,0,0,0,0
"2011","Redbridge","E09000026","Rural village in a sparse setting",0,0,0,0,0,0,0,0,0
"2011","Redbridge","E09000026","Rural hamlet and isolated dwellings",0,0,0,0,0,0,0,0,0
"2011","Redbridge","E09000026","Rural hamlet and isolated dwellings in a sparse setting",0,0,0,0,0,0,0,0,0
"2011","Richmond upon Thames","E09000027","Total",79835,19706,1989,17717,23653,10793,14830,2403,12427
"2011","Richmond upon Thames","E09000027","Urban (total)",79835,19706,1989,17717,23653,10793,14830,2403,12427
"2011","Richmond upon Thames","E09000027","Urban major conurbation",79835,19706,1989,17717,23653,10793,14830,2403,12427
"2011","Richmond upon Thames","E09000027","Urban minor conurbation",0,0,0,0,0,0,0,0,0
"2011","Richmond upon Thames","E09000027","Urban city and town",0,0,0,0,0,0,0,0,0
"2011","Richmond upon Thames","E09000027","Urban city and town in a sparse setting",0,0,0,0,0,0,0,0,0
"2011","Richmond upon Thames","E09000027","Rural (total)",0,0,0,0,0,0,0,0,0
"2011","Richmond upon Thames","E09000027","Rural town and fringe",0,0,0,0,0,0,0,0,0
"2011","Richmond upon Thames","E09000027","Rural town and fringe in a sparse setting",0,0,0,0,0,0,0,0,0
"2011","Richmond upon Thames","E09000027","Rural village",0,0,0,0,0,0,0,0,0
"2011","Richmond upon Thames","E09000027","Rural village in a sparse setting",0,0,0,0,0,0,0,0,0
"2011","Richmond upon Thames","E09000027","Rural hamlet and isolated dwellings",0,0,0,0,0,0,0,0,0
"2011","Richmond upon Thames","E09000027","Rural hamlet and isolated dwellings in a sparse setting",0,0,0,0,0,0,0,0,0
"2011","Sutton","E09000029","Total",78174,21566,2849,18717,25363,10285,17375,3483,13892
"2011","Sutton","E09000029","Urban (total)",78174,21566,2849,18717,25363,10285,17375,3483,13892
"2011","Sutton","E09000029","Urban major conurbation",78048,21536,2841,18695,25319,10270,17342,3473,13869
"2011","Sutton","E09000029","Urban minor conurbation",0,0,0,0,0,0,0,0,0
"2011","Sutton","E09000029","Urban city and town",126,30,8,22,44,15,33,10,23
"2011","Sutton","E09000029","Urban city and town in a sparse setting",0,0,0,0,0,0,0,0,0
"2011","Sutton","E09000029","Rural (total)",0,0,0,0,0,0,0,0,0
"2011","Sutton","E09000029","Rural town and fringe",0,0,0,0,0,0,0,0,0
"2011","Sutton","E09000029","Rural town and fringe in a sparse setting",0,0,0,0,0,0,0,0,0
"2011","Sutton","E09000029","Rural village",0,0,0,0,0,0,0,0,0
"2011","Sutton","E09000029","Rural village in a sparse setting",0,0,0,0,0,0,0,0,0
"2011","Sutton","E09000029","Rural hamlet and isolated dwellings",0,0,0,0,0,0,0,0,0
"2011","Sutton","E09000029","Rural hamlet and isolated dwellings in a sparse setting",0,0,0,0,0,0,0,0,0
"2011","Waltham Forest","E09000031","Total",96861,27279,6202,21077,33670,16122,23219,5581,17638
"2011","Waltham Forest","E09000031","Urban (total)",96861,27279,6202,21077,33670,16122,23219,5581,17638
"2011","Waltham Forest","E09000031","Urban major conurbation",96861,27279,6202,21077,33670,16122,23219,5581,17638
"2011","Waltham Forest","E09000031","Urban minor conurbation",0,0,0,0,0,0,0,0,0
"2011","Waltham Forest","E09000031","Urban city and town",0,0,0,0,0,0,0,0,0
"2011","Waltham Forest","E09000031","Urban city and town in a sparse setting",0,0,0,0,0,0,0,0,0
"2011","Waltham Forest","E09000031","Rural (total)",0,0,0,0,0,0,0,0,0
"2011","Waltham Forest","E09000031","Rural town and fringe",0,0,0,0,0,0,0,0,0
"2011","Waltham Forest","E09000031","Rural town and fringe in a sparse setting",0,0,0,0,0,0,0,0,0
"2011","Waltham Forest","E09000031","Rural village",0,0,0,0,0,0,0,0,0
"2011","Waltham Forest","E09000031","Rural village in a sparse setting",0,0,0,0,0,0,0,0,0
"2011","Waltham Forest","E09000031","Rural hamlet and isolated dwellings",0,0,0,0,0,0,0,0,0
"2011","Waltham Forest","E09000031","Rural hamlet and isolated dwellings in a sparse setting",0,0,0,0,0,0,0,0,0
"2011","Bracknell Forest","E06000036","Total",45878,10914,1317,9597,14942,6314,9075,1746,7329
"2011","Bracknell Forest","E06000036","Urban (total)",44854,10657,1304,9353,14706,6236,8883,1728,7155
"2011","Bracknell Forest","E06000036","Urban major conurbation",0,0,0,0,0,0,0,0,0
"2011","Bracknell Forest","E06000036","Urban minor conurbation",0,0,0,0,0,0,0,0,0
"2011","Bracknell Forest","E06000036","Urban city and town",44854,10657,1304,9353,14706,6236,8883,1728,7155
"2011","Bracknell Forest","E06000036","Urban city and town in a sparse setting",0,0,0,0,0,0,0,0,0
"2011","Bracknell Forest","E06000036","Rural (total)",1024,257,13,244,236,78,192,18,174
"2011","Bracknell Forest","E06000036","Rural town and fringe",46,20,1,19,12,4,12,1,11
"2011","Bracknell Forest","E06000036","Rural town and fringe in a sparse setting",0,0,0,0,0,0,0,0,0
"2011","Bracknell Forest","E06000036","Rural village",529,168,7,161,89,29,117,8,109
"2011","Bracknell Forest","E06000036","Rural village in a sparse setting",0,0,0,0,0,0,0,0,0
"2011","Bracknell Forest","E06000036","Rural hamlet and isolated dwellings",449,69,5,64,135,45,63,9,54
"2011","Bracknell Forest","E06000036","Rural hamlet and isolated dwellings in a sparse setting",0,0,0,0,0,0,0,0,0
"2011","Brighton and Hove","E06000043","Total",121540,36791,4481,32310,29822,12134,29912,4690,25222
"2011","Brighton and Hove","E06000043","Urban (total)",121183,36643,4468,32175,29726,12098,29796,4675,25121
"2011","Brighton and Hove","E06000043","Urban major conurbation",0,0,0,0,0,0,0,0,0
"2011","Brighton and Hove","E06000043","Urban minor conurbation",0,0,0,0,0,0,0,0,0
"2011","Brighton and Hove","E06000043","Urban city and town",121183,36643,4468,32175,29726,12098,29796,4675,25121
"2011","Brighton and Hove","E06000043","Urban city and town in a sparse setting",0,0,0,0,0,0,0,0,0
"2011","Brighton and Hove","E06000043","Rural (total)",357,148,13,135,96,36,116,15,101
"2011","Brighton and Hove","E06000043","Rural town and fringe",141,59,7,52,49,18,43,9,34
"2011","Brighton and Hove","E06000043","Rural town and fringe in a sparse setting",0,0,0,0,0,0,0,0,0
"2011","Brighton and Hove","E06000043","Rural village",0,0,0,0,0,0,0,0,0
"2011","Brighton and Hove","E06000043","Rural village in a sparse setting",0,0,0,0,0,0,0,0,0
"2011","Brighton and Hove","E06000043","Rural hamlet and isolated dwellings",216,89,6,83,47,18,73,6,67
"2011","Brighton and Hove","E06000043","Rural hamlet and isolated dwellings in a sparse setting",0,0,0,0,0,0,0,0,0
"2011","Isle of Wight","E06000046","Total",61085,25183,2320,22863,15263,5169,18019,2812,15207
"2011","Isle of Wight","E06000046","Urban (total)",40769,16065,1762,14303,11058,3933,11814,2010,9804
"2011","Isle of Wight","E06000046","Urban major conurbation",0,0,0,0,0,0,0,0,0
"2011","Isle of Wight","E06000046","Urban minor conurbation",0,0,0,0,0,0,0,0,0
"2011","Isle of Wight","E06000046","Urban city and town",40769,16065,1762,14303,11058,3933,11814,2010,9804
"2011","Isle of Wight","E06000046","Urban city and town in a sparse setting",0,0,0,0,0,0,0,0,0
"2011","Isle of Wight","E06000046","Rural (total)",20316,9118,558,8560,4205,1236,6205,802,5403
"2011","Isle of Wight","E06000046","Rural town and fringe",12356,5855,404,5451,2574,796,3956,518,3438
"2011","Isle of Wight","E06000046","Rural town and fringe in a sparse setting",0,0,0,0,0,0,0,0,0
"2011","Isle of Wight","E06000046","Rural village",4606,2102,99,2003,867,238,1349,150,1199
"2011","Isle of Wight","E06000046","Rural village in a sparse setting",0,0,0,0,0,0,0,0,0
"2011","Isle of Wight","E06000046","Rural hamlet and isolated dwellings",3354,1161,55,1106,764,202,900,134,766
"2011","Isle of Wight","E06000046","Rural hamlet and isolated dwellings in a sparse setting",0,0,0,0,0,0,0,0,0
"2011","Medway","E06000035","Total",106209,33370,5228,28142,34331,13710,26489,5568,20921
"2011","Medway","E06000035","Urban (total)",94677,29903,4893,25010,30812,12428,23625,5034,18591
"2011","Medway","E06000035","Urban major conurbation",0,0,0,0,0,0,0,0,0
"2011","Medway","E06000035","Urban minor conurbation",0,0,0,0,0,0,0,0,0
"2011","Medway","E06000035","Urban city and town",94677,29903,4893,25010,30812,12428,23625,5034,18591
"2011","Medway","E06000035","Urban city and town in a sparse setting",0,0,0,0,0,0,0,0,0
"2011","Medway","E06000035","Rural (total)",11532,3467,335,3132,3519,1282,2864,534,2330
"2011","Medway","E06000035","Rural town and fringe",8487,2657,219,2438,2526,885,2164,380,1784
"2011","Medway","E06000035","Rural town and fringe in a sparse setting",0,0,0,0,0,0,0,0,0
"2011","Medway","E06000035","Rural village",1906,516,101,415,651,263,469,116,353
"2011","Medway","E06000035","Rural village in a sparse setting",0,0,0,0,0,0,0,0,0
"2011","Medway","E06000035","Rural hamlet and isolated dwellings",1139,294,15,279,342,134,231,38,193
"2011","Medway","E06000035","Rural hamlet and isolated dwellings in a sparse setting",0,0,0,0,0,0,0,0,0
"2011","Milton Keynes","E06000042","Total",98584,25126,4306,20820,34475,15569,21525,4643,16882
"2011","Milton Keynes","E06000042","Urban (total)",89555,22761,4135,18626,31792,14425,19725,4338,15387
"2011","Milton Keynes","E06000042","Urban major conurbation",0,0,0,0,0,0,0,0,0
"2011","Milton Keynes","E06000042","Urban minor conurbation",0,0,0,0,0,0,0,0,0
"2011","Milton Keynes","E06000042","Urban city and town",89555,22761,4135,18626,31792,14425,19725,4338,15387
"2011","Milton Keynes","E06000042","Urban city and town in a sparse setting",0,0,0,0,0,0,0,0,0
"2011","Milton Keynes","E06000042","Rural (total)",9029,2365,171,2194,2683,1144,1800,305,1495
"2011","Milton Keynes","E06000042","Rural town and fringe",4906,1205,102,1103,1536,696,922,170,752
"2011","Milton Keynes","E06000042","Rural town and fringe in a sparse setting",0,0,0,0,0,0,0,0,0
"2011","Milton Keynes","E06000042","Rural village",3609,1057,62,995,1010,388,787,116,671
"2011","Milton Keynes","E06000042","Rural village in a sparse setting",0,0,0,0,0,0,0,0,0
"2011","Milton Keynes","E06000042","Rural hamlet and isolated dwellings",514,103,7,96,137,60,91,19,72
"2011","Milton Keynes","E06000042","Rural hamlet and isolated dwellings in a sparse setting",0,0,0,0,0,0,0,0,0
"2011","Portsmouth","E06000044","Total",85473,28443,4310,24133,24482,10723,21293,3898,17395
"2011","Portsmouth","E06000044","Urban (total)",85473,28443,4310,24133,24482,10723,21293,3898,17395
"2011","Portsmouth","E06000044","Urban major conurbation",0,0,0,0,0,0,0,0,0
"2011","Portsmouth","E06000044","Urban minor conurbation",0,0,0,0,0,0,0,0,0
"2011","Portsmouth","E06000044","Urban city and town",85473,28443,4310,24133,24482,10723,21293,3898,17395
"2011","Portsmouth","E06000044","Urban city and town in a sparse setting",0,0,0,0,0,0,0,0,0
"2011","Portsmouth","E06000044","Rural (total)",0,0,0,0,0,0,0,0,0
"2011","Portsmouth","E06000044","Rural town and fringe",0,0,0,0,0,0,0,0,0
"2011","Portsmouth","E06000044","Rural town and fringe in a sparse setting",0,0,0,0,0,0,0,0,0
"2011","Portsmouth","E06000044","Rural village",0,0,0,0,0,0,0,0,0
"2011","Portsmouth","E06000044","Rural village in a sparse setting",0,0,0,0,0,0,0,0,0
"2011","Portsmouth","E06000044","Rural hamlet and isolated dwellings",0,0,0,0,0,0,0,0,0
"2011","Portsmouth","E06000044","Rural hamlet and isolated dwellings in a sparse setting",0,0,0,0,0,0,0,0,0
"2011","Reading","E06000038","Total",62869,16510,2795,13715,18911,9352,12762,2660,10102
"2011","Reading","E06000038","Urban (total)",62633,16482,2783,13699,18845,9306,12745,2654,10091
"2011","Reading","E06000038","Urban major conurbation",0,0,0,0,0,0,0,0,0
"2011","Reading","E06000038","Urban minor conurbation",0,0,0,0,0,0,0,0,0
"2011","Reading","E06000038","Urban city and town",62633,16482,2783,13699,18845,9306,12745,2654,10091
"2011","Reading","E06000038","Urban city and town in a sparse setting",0,0,0,0,0,0,0,0,0
"2011","Reading","E06000038","Rural (total)",236,28,12,16,66,46,17,6,11
"2011","Reading","E06000038","Rural town and fringe",236,28,12,16,66,46,17,6,11
"2011","Reading","E06000038","Rural town and fringe in a sparse setting",0,0,0,0,0,0,0,0,0
"2011","Reading","E06000038","Rural village",0,0,0,0,0,0,0,0,0
"2011","Reading","E06000038","Rural village in a sparse setting",0,0,0,0,0,0,0,0,0
"2011","Reading","E06000038","Rural hamlet and isolated dwellings",0,0,0,0,0,0,0,0,0
"2011","Reading","E06000038","Rural hamlet and isolated dwellings in a sparse setting",0,0,0,0,0,0,0,0,0
"2011","Slough","E06000039","Total",50766,12477,2911,9566,19882,9884,11388,3186,8202
"2011","Slough","E06000039","Urban (total)",50766,12477,2911,9566,19882,9884,11388,3186,8202
"2011","Slough","E06000039","Urban major conurbation",0,0,0,0,0,0,0,0,0
"2011","Slough","E06000039","Urban minor conurbation",0,0,0,0,0,0,0,0,0
"2011","Slough","E06000039","Urban city and town",50766,12477,2911,9566,19882,9884,11388,3186,8202
"2011","Slough","E06000039","Urban city and town in a sparse setting",0,0,0,0,0,0,0,0,0
"2011","Slough","E06000039","Rural (total)",0,0,0,0,0,0,0,0,0
"2011","Slough","E06000039","Rural town and fringe",0,0,0,0,0,0,0,0,0
"2011","Slough","E06000039","Rural town and fringe in a sparse setting",0,0,0,0,0,0,0,0,0
"2011","Slough","E06000039","Rural village",0,0,0,0,0,0,0,0,0
"2011","Slough","E06000039","Rural village in a sparse setting",0,0,0,0,0,0,0,0,0
"2011","Slough","E06000039","Rural hamlet and isolated dwellings",0,0,0,0,0,0,0,0,0
"2011","Slough","E06000039","Rural hamlet and isolated dwellings in a sparse setting",0,0,0,0,0,0,0,0,0
"2011","Southampton","E06000045","Total",98254,32271,4539,27732,25994,12042,24641,4306,20335
"2011","Southampton","E06000045","Urban (total)",98254,32271,4539,27732,25994,12042,24641,4306,20335
"2011","Southampton","E06000045","Urban major conurbation",0,0,0,0,0,0,0,0,0
"2011","Southampton","E06000045","Urban minor conurbation",0,0,0,0,0,0,0,0,0
"2011","Southampton","E06000045","Urban city and town",98254,32271,4539,27732,25994,12042,24641,4306,20335
"2011","Southampton","E06000045","Urban city and town in a sparse setting",0,0,0,0,0,0,0,0,0
"2011","Southampton","E06000045","Rural (total)",0,0,0,0,0,0,0,0,0
"2011","Southampton","E06000045","Rural town and fringe",0,0,0,0,0,0,0,0,0
"2011","Southampton","E06000045","Rural town and fringe in a sparse setting",0,0,0,0,0,0,0,0,0
"2011","Southampton","E06000045","Rural village",0,0,0,0,0,0,0,0,0
"2011","Southampton","E06000045","Rural village in a sparse setting",0,0,0,0,0,0,0,0,0
"2011","Southampton","E06000045","Rural hamlet and isolated dwellings",0,0,0,0,0,0,0,0,0
"2011","Southampton","E06000045","Rural hamlet and isolated dwellings in a sparse setting",0,0,0,0,0,0,0,0,0
"2011","West Berkshire","E06000037","Total",62340,16102,1477,14625,19253,7772,12956,2397,10559
"2011","West Berkshire","E06000037","Urban (total)",39612,10254,1043,9211,12327,5099,8322,1573,6749
"2011","West Berkshire","E06000037","Urban major conurbation",0,0,0,0,0,0,0,0,0
"2011","West Berkshire","E06000037","Urban minor conurbation",0,0,0,0,0,0,0,0,0
"2011","West Berkshire","E06000037","Urban city and town",39612,10254,1043,9211,12327,5099,8322,1573,6749
"2011","West Berkshire","E06000037","Urban city and town in a sparse setting",0,0,0,0,0,0,0,0,0
"2011","West Berkshire","E06000037","Rural (total)",22728,5848,434,5414,6926,2673,4634,824,3810
"2011","West Berkshire","E06000037","Rural town and fringe",10011,2830,221,2609,2982,1215,2207,374,1833
"2011","West Berkshire","E06000037","Rural town and fringe in a sparse setting",0,0,0,0,0,0,0,0,0
"2011","West Berkshire","E06000037","Rural village",7466,1799,127,1672,2400,921,1448,266,1182
"2011","West Berkshire","E06000037","Rural village in a sparse setting",0,0,0,0,0,0,0,0,0
"2011","West Berkshire","E06000037","Rural hamlet and isolated dwellings",5251,1219,86,1133,1544,537,979,184,795
"2011","West Berkshire","E06000037","Rural hamlet and isolated dwellings in a sparse setting",0,0,0,0,0,0,0,0,0
"2011","Windsor and Maidenhead","E06000040","Total",58349,15536,1258,14278,17697,7205,11548,1949,9599
"2011","Windsor and Maidenhead","E06000040","Urban (total)",52202,13982,1132,12850,15917,6533,10334,1747,8587
"2011","Windsor and Maidenhead","E06000040","Urban major conurbation",133,22,1,21,51,24,28,9,19
"2011","Windsor and Maidenhead","E06000040","Urban minor conurbation",0,0,0,0,0,0,0,0,0
"2011","Windsor and Maidenhead","E06000040","Urban city and town",52069,13960,1131,12829,15866,6509,10306,1738,8568
"2011","Windsor and Maidenhead","E06000040","Urban city and town in a sparse setting",0,0,0,0,0,0,0,0,0
"2011","Windsor and Maidenhead","E06000040","Rural (total)",6147,1554,126,1428,1780,672,1214,202,1012
"2011","Windsor and Maidenhead","E06000040","Rural town and fringe",2909,777,72,705,804,339,604,94,510
"2011","Windsor and Maidenhead","E06000040","Rural town and fringe in a sparse setting",0,0,0,0,0,0,0,0,0
"2011","Windsor and Maidenhead","E06000040","Rural village",2450,594,48,546,735,257,472,89,383
"2011","Windsor and Maidenhead","E06000040","Rural village in a sparse setting",0,0,0,0,0,0,0,0,0
"2011","Windsor and Maidenhead","E06000040","Rural hamlet and isolated dwellings",788,183,6,177,241,76,138,19,119
"2011","Windsor and Maidenhead","E06000040","Rural hamlet and isolated dwellings in a sparse setting",0,0,0,0,0,0,0,0,0
"2011","Wokingham","E06000041","Total",60332,15075,1047,14028,20018,7787,11549,2201,9348
"2011","Wokingham","E06000041","Urban (total)",49568,12370,907,11463,16666,6415,9480,1862,7618
"2011","Wokingham","E06000041","Urban major conurbation",0,0,0,0,0,0,0,0,0
"2011","Wokingham","E06000041","Urban minor conurbation",0,0,0,0,0,0,0,0,0
"2011","Wokingham","E06000041","Urban city and town",49568,12370,907,11463,16666,6415,9480,1862,7618
"2011","Wokingham","E06000041","Urban city and town in a sparse setting",0,0,0,0,0,0,0,0,0
"2011","Wokingham","E06000041","Rural (total)",10764,2705,140,2565,3352,1372,2069,339,1730
"2011","Wokingham","E06000041","Rural town and fringe",6650,1722,70,1652,2057,867,1289,209,1080
"2011","Wokingham","E06000041","Rural town and fringe in a sparse setting",0,0,0,0,0,0,0,0,0
"2011","Wokingham","E06000041","Rural village",2046,473,46,427,691,262,366,69,297
"2011","Wokingham","E06000041","Rural village in a sparse setting",0,0,0,0,0,0,0,0,0
"2011","Wokingham","E06000041","Rural hamlet and isolated dwellings",2068,510,24,486,604,243,414,61,353
"2011","Wokingham","E06000041","Rural hamlet and isolated dwellings in a sparse setting",0,0,0,0,0,0,0,0,0
"2011","Buckinghamshire","E10000002","Total",200727,54988,4536,50452,63637,24440,42452,7796,34656
"2011","Buckinghamshire","E10000002","Urban (total)",134331,36375,3507,32868,43394,17514,28330,5523,22807
"2011","Buckinghamshire","E10000002","Urban major conurbation",571,166,14,152,171,77,130,21,109
"2011","Buckinghamshire","E10000002","Urban minor conurbation",0,0,0,0,0,0,0,0,0
"2011","Buckinghamshire","E10000002","Urban city and town",133760,36209,3493,32716,43223,17437,28200,5502,22698
"2011","Buckinghamshire","E10000002","Urban city and town in a sparse setting",0,0,0,0,0,0,0,0,0
"2011","Buckinghamshire","E10000002","Rural (total)",66396,18613,1029,17584,20243,6926,14122,2273,11849
"2011","Buckinghamshire","E10000002","Rural town and fringe",34212,10468,635,9833,10352,3786,7870,1210,6660
"2011","Buckinghamshire","E10000002","Rural town and fringe in a sparse setting",0,0,0,0,0,0,0,0,0
"2011","Buckinghamshire","E10000002","Rural village",21984,5649,256,5393,6827,2175,4348,730,3618
"2011","Buckinghamshire","E10000002","Rural village in a sparse setting",0,0,0,0,0,0,0,0,0
"2011","Buckinghamshire","E10000002","Rural hamlet and isolated dwellings",10200,2496,138,2358,3064,965,1904,333,1571
"2011","Buckinghamshire","E10000002","Rural hamlet and isolated dwellings in a sparse setting",0,0,0,0,0,0,0,0,0
"2011","East Sussex","E10000011","Total",231905,88797,7491,81306,59013,21612,64740,9811,54929
"2011","East Sussex","E10000011","Urban (total)",174549,68894,6364,62530,44291,16796,50225,7628,42597
"2011","East Sussex","E10000011","Urban major conurbation",0,0,0,0,0,0,0,0,0
"2011","East Sussex","E10000011","Urban minor conurbation",0,0,0,0,0,0,0,0,0
"2011","East Sussex","E10000011","Urban city and town",174549,68894,6364,62530,44291,16796,50225,7628,42597
"2011","East Sussex","E10000011","Urban city and town in a sparse setting",0,0,0,0,0,0,0,0,0
"2011","East Sussex","E10000011","Rural (total)",57356,19903,1127,18776,14722,4816,14515,2183,12332
"2011","East Sussex","E10000011","Rural town and fringe",21780,8771,482,8289,5186,1772,6076,856,5220
"2011","East Sussex","E10000011","Rural town and fringe in a sparse setting",0,0,0,0,0,0,0,0,0
"2011","East Sussex","E10000011","Rural village",21011,7021,453,6568,5644,1858,5205,812,4393
"2011","East Sussex","E10000011","Rural village in a sparse setting",0,0,0,0,0,0,0,0,0
"2011","East Sussex","E10000011","Rural hamlet and isolated dwellings",14565,4111,192,3919,3892,1186,3234,515,2719
"2011","East Sussex","E10000011","Rural hamlet and isolated dwellings in a sparse setting",0,0,0,0,0,0,0,0,0
"2011","Hampshire","E10000014","Total",545254,167258,14040,153218,159823,60773,127852,22054,105798
"2011","Hampshire","E10000014","Urban (total)",428137,131943,12221,119722,126924,49284,101870,18029,83841
"2011","Hampshire","E10000014","Urban major conurbation",0,0,0,0,0,0,0,0,0
"2011","Hampshire","E10000014","Urban minor conurbation",0,0,0,0,0,0,0,0,0
"2011","Hampshire","E10000014","Urban city and town",428137,131943,12221,119722,126924,49284,101870,18029,83841
"2011","Hampshire","E10000014","Urban city and town in a sparse setting",0,0,0,0,0,0,0,0,0
"2011","Hampshire","E10000014","Rural (total)",117117,35315,1819,33496,32899,11489,25982,4025,21957
"2011","Hampshire","E10000014","Rural town and fringe",59051,18996,1046,17950,16505,6044,13713,2070,11643
"2011","Hampshire","E10000014","Rural town and fringe in a sparse setting",0,0,0,0,0,0,0,0,0
"2011","Hampshire","E10000014","Rural village",33232,9559,484,9075,9665,3362,7138,1182,5956
"2011","Hampshire","E10000014","Rural village in a sparse setting",0,0,0,0,0,0,0,0,0
"2011","Hampshire","E10000014","Rural hamlet and isolated dwellings",24834,6760,289,6471,6729,2083,5131,773,4358
"2011","Hampshire","E10000014","Rural hamlet and isolated dwellings in a sparse setting",0,0,0,0,0,0,0,0,0
"2011","Kent","E10000016","Total",605638,203263,23153,180110,179568,70155,154753,27729,127024
"2011","Kent","E10000016","Urban (total)",441044,149867,19059,130808,132199,53639,113948,20914,93034
"2011","Kent","E10000016","Urban major conurbation",74582,22539,3470,19069,24548,10293,17932,3813,14119
"2011","Kent","E10000016","Urban minor conurbation",0,0,0,0,0,0,0,0,0
"2011","Kent","E10000016","Urban city and town",366462,127328,15589,111739,107651,43346,96016,17101,78915
"2011","Kent","E10000016","Urban city and town in a sparse setting",0,0,0,0,0,0,0,0,0
"2011","Kent","E10000016","Rural (total)",164594,53396,4094,49302,47369,16516,40805,6815,33990
"2011","Kent","E10000016","Rural town and fringe",84386,28497,2431,26066,24937,9228,21757,3727,18030
"2011","Kent","E10000016","Rural town and fringe in a sparse setting",0,0,0,0,0,0,0,0,0
"2011","Kent","E10000016","Rural village",47660,15909,1102,14807,13047,4357,11848,1846,10002
"2011","Kent","E10000016","Rural village in a sparse setting",0,0,0,0,0,0,0,0,0
"2011","Kent","E10000016","Rural hamlet and isolated dwellings",32548,8990,561,8429,9385,2931,7200,1242,5958
"2011","Kent","E10000016","Rural hamlet and isolated dwellings in a sparse setting",0,0,0,0,0,0,0,0,0
"2011","Oxfordshire","E10000025","Total",258855,71377,6759,64618,75949,31649,56264,9621,46643
"2011","Oxfordshire","E10000025","Urban (total)",171138,46798,5434,41364,50647,22279,37158,6666,30492
"2011","Oxfordshire","E10000025","Urban major conurbation",0,0,0,0,0,0,0,0,0
"2011","Oxfordshire","E10000025","Urban minor conurbation",0,0,0,0,0,0,0,0,0
"2011","Oxfordshire","E10000025","Urban city and town",171138,46798,5434,41364,50647,22279,37158,6666,30492
"2011","Oxfordshire","E10000025","Urban city and town in a sparse setting",0,0,0,0,0,0,0,0,0
"2011","Oxfordshire","E10000025","Rural (total)",87717,24579,1325,23254,25302,9370,19106,2955,16151
"2011","Oxfordshire","E10000025","Rural town and fringe",41359,12536,696,11840,12081,4719,9527,1440,8087
"2011","Oxfordshire","E10000025","Rural town and fringe in a sparse setting",0,0,0,0,0,0,0,0,0
"2011","Oxfordshire","E10000025","Rural village",36765,9793,521,9272,10490,3721,7739,1205,6534
"2011","Oxfordshire","E10000025","Rural village in a sparse setting",0,0,0,0,0,0,0,0,0
"2011","Oxfordshire","E10000025","Rural hamlet and isolated dwellings",9593,2250,108,2142,2731,930,1840,310,1530
"2011","Oxfordshire","E10000025","Rural hamlet and isolated dwellings in a sparse setting",0,0,0,0,0,0,0,0,0
"2011","Surrey","E10000030","Total",455791,127689,9768,117921,138708,55197,95766,16070,79696
"2011","Surrey","E10000030","Urban (total)",395229,110308,8822,101486,120948,49008,82974,14094,68880
"2011","Surrey","E10000030","Urban major conurbation",223435,63139,5065,58074,68685,27994,47646,8152,39494
"2011","Surrey","E10000030","Urban minor conurbation",0,0,0,0,0,0,0,0,0
"2011","Surrey","E10000030","Urban city and town",171794,47169,3757,43412,52263,21014,35328,5942,29386
"2011","Surrey","E10000030","Urban city and town in a sparse setting",0,0,0,0,0,0,0,0,0
"2011","Surrey","E10000030","Rural (total)",60562,17381,946,16435,17760,6189,12792,1976,10816
"2011","Surrey","E10000030","Rural town and fringe",26551,7885,471,7414,7963,3017,5934,938,4996
"2011","Surrey","E10000030","Rural town and fringe in a sparse setting",0,0,0,0,0,0,0,0,0
"2011","Surrey","E10000030","Rural village",19133,5654,285,5369,5470,1849,3952,570,3382
"2011","Surrey","E10000030","Rural village in a sparse setting",0,0,0,0,0,0,0,0,0
"2011","Surrey","E10000030","Rural hamlet and isolated dwellings",14878,3842,190,3652,4327,1323,2906,468,2438
"2011","Surrey","E10000030","Rural hamlet and isolated dwellings in a sparse setting",0,0,0,0,0,0,0,0,0
"2011","West Sussex","E10000032","Total",345614,117348,8688,108660,93121,36414,86102,13053,73049
"2011","West Sussex","E10000032","Urban (total)",266164,91453,7255,84198,71832,29051,67700,10304,57396
"2011","West Sussex","E10000032","Urban major conurbation",0,0,0,0,0,0,0,0,0
"2011","West Sussex","E10000032","Urban minor conurbation",0,0,0,0,0,0,0,0,0
"2011","West Sussex","E10000032","Urban city and town",266164,91453,7255,84198,71832,29051,67700,10304,57396
"2011","West Sussex","E10000032","Urban city and town in a sparse setting",0,0,0,0,0,0,0,0,0
"2011","West Sussex","E10000032","Rural (total)",79450,25895,1433,24462,21289,7363,18402,2749,15653
"2011","West Sussex","E10000032","Rural town and fringe",44115,15556,904,14652,11677,4214,10913,1557,9356
"2011","West Sussex","E10000032","Rural town and fringe in a sparse setting",0,0,0,0,0,0,0,0,0
"2011","West Sussex","E10000032","Rural village",19105,5939,316,5623,5261,1812,4194,638,3556
"2011","West Sussex","E10000032","Rural village in a sparse setting",0,0,0,0,0,0,0,0,0
"2011","West Sussex","E10000032","Rural hamlet and isolated dwellings",16230,4400,213,4187,4351,1337,3295,554,2741
"2011","West Sussex","E10000032","Rural hamlet and isolated dwellings in a sparse setting",0,0,0,0,0,0,0,0,0
"2011","Bath and North East Somerset","E06000022","Total",73515,24498,1967,22531,19116,7206,17939,2709,15230
"2011","Bath and North East Somerset","E06000022","Urban (total)",58763,20036,1705,18331,14796,5756,14479,2129,12350
"2011","Bath and North East Somerset","E06000022","Urban major conurbation",0,0,0,0,0,0,0,0,0
"2011","Bath and North East Somerset","E06000022","Urban minor conurbation",0,0,0,0,0,0,0,0,0
"2011","Bath and North East Somerset","E06000022","Urban city and town",58763,20036,1705,18331,14796,5756,14479,2129,12350
"2011","Bath and North East Somerset","E06000022","Urban city and town in a sparse setting",0,0,0,0,0,0,0,0,0
"2011","Bath and North East Somerset","E06000022","Rural (total)",14752,4462,262,4200,4320,1450,3460,580,2880
"2011","Bath and North East Somerset","E06000022","Rural town and fringe",6509,2043,126,1917,1960,736,1577,252,1325
"2011","Bath and North East Somerset","E06000022","Rural town and fringe in a sparse setting",0,0,0,0,0,0,0,0,0
"2011","Bath and North East Somerset","E06000022","Rural village",6512,2003,113,1890,1843,569,1522,270,1252
"2011","Bath and North East Somerset","E06000022","Rural village in a sparse setting",0,0,0,0,0,0,0,0,0
"2011","Bath and North East Somerset","E06000022","Rural hamlet and isolated dwellings",1731,416,23,393,517,145,361,58,303
"2011","Bath and North East Somerset","E06000022","Rural hamlet and isolated dwellings in a sparse setting",0,0,0,0,0,0,0,0,0
"2011","Bournemouth","E06000028","Total",82374,28818,2629,26189,18913,8193,21379,3101,18278
"2011","Bournemouth","E06000028","Urban (total)",82325,28801,2625,26176,18893,8186,21370,3098,18272
"2011","Bournemouth","E06000028","Urban major conurbation",0,0,0,0,0,0,0,0,0
"2011","Bournemouth","E06000028","Urban minor conurbation",0,0,0,0,0,0,0,0,0
"2011","Bournemouth","E06000028","Urban city and town",82325,28801,2625,26176,18893,8186,21370,3098,18272
"2011","Bournemouth","E06000028","Urban city and town in a sparse setting",0,0,0,0,0,0,0,0,0
"2011","Bournemouth","E06000028","Rural (total)",49,17,4,13,20,7,9,3,6
"2011","Bournemouth","E06000028","Rural town and fringe",0,0,0,0,0,0,0,0,0
"2011","Bournemouth","E06000028","Rural town and fringe in a sparse setting",0,0,0,0,0,0,0,0,0
"2011","Bournemouth","E06000028","Rural village",0,0,0,0,0,0,0,0,0
"2011","Bournemouth","E06000028","Rural village in a sparse setting",0,0,0,0,0,0,0,0,0
"2011","Bournemouth","E06000028","Rural hamlet and isolated dwellings",49,17,4,13,20,7,9,3,6
"2011","Bournemouth","E06000028","Rural hamlet and isolated dwellings in a sparse setting",0,0,0,0,0,0,0,0,0
"2011","Bristol, City of","E06000023","Total",182747,58638,9462,49176,48487,22784,45384,7909,37475
"2011","Bristol, City of","E06000023","Urban (total)",182747,58638,9462,49176,48487,22784,45384,7909,37475
"2011","Bristol, City of","E06000023","Urban major conurbation",0,0,0,0,0,0,0,0,0
"2011","Bristol, City of","E06000023","Urban minor conurbation",0,0,0,0,0,0,0,0,0
"2011","Bristol, City of","E06000023","Urban city and town",182747,58638,9462,49176,48487,22784,45384,7909,37475
"2011","Bristol, City of","E06000023","Urban city and town in a sparse setting",0,0,0,0,0,0,0,0,0
"2011","Bristol, City of","E06000023","Rural (total)",0,0,0,0,0,0,0,0,0
"2011","Bristol, City of","E06000023","Rural town and fringe",0,0,0,0,0,0,0,0,0
"2011","Bristol, City of","E06000023","Rural town and fringe in a sparse setting",0,0,0,0,0,0,0,0,0
"2011","Bristol, City of","E06000023","Rural village",0,0,0,0,0,0,0,0,0
"2011","Bristol, City of","E06000023","Rural village in a sparse setting",0,0,0,0,0,0,0,0,0
"2011","Bristol, City of","E06000023","Rural hamlet and isolated dwellings",0,0,0,0,0,0,0,0,0
"2011","Bristol, City of","E06000023","Rural hamlet and isolated dwellings in a sparse setting",0,0,0,0,0,0,0,0,0
"2011","Cornwall","E06000052","Total",230389,87159,7222,79937,58768,21473,66442,10369,56073
"2011","Cornwall","E06000052","Urban (total)",89190,34179,3383,30796,23579,9048,26185,4182,22003
"2011","Cornwall","E06000052","Urban major conurbation",0,0,0,0,0,0,0,0,0
"2011","Cornwall","E06000052","Urban minor conurbation",0,0,0,0,0,0,0,0,0
"2011","Cornwall","E06000052","Urban city and town",89190,34179,3383,30796,23579,9048,26185,4182,22003
"2011","Cornwall","E06000052","Urban city and town in a sparse setting",0,0,0,0,0,0,0,0,0
"2011","Cornwall","E06000052","Rural (total)",141199,52980,3839,49141,35189,12425,40257,6187,34070
"2011","Cornwall","E06000052","Rural town and fringe",53403,21054,1834,19220,13881,5122,15946,2457,13489
"2011","Cornwall","E06000052","Rural town and fringe in a sparse setting",11322,4608,444,4164,2798,1075,3415,533,2882
"2011","Cornwall","E06000052","Rural village",35279,13356,849,12507,8624,2965,9835,1510,8325
"2011","Cornwall","E06000052","Rural village in a sparse setting",8594,3357,174,3183,1962,701,2431,332,2099
"2011","Cornwall","E06000052","Rural hamlet and isolated dwellings",26823,8707,444,8263,6572,2069,7077,1130,5947
"2011","Cornwall","E06000052","Rural hamlet and isolated dwellings in a sparse setting",5778,1898,94,1804,1352,493,1553,225,1328
"2011","Isles of Scilly","E06000053","Total",989,249,2,247,196,76,208,19,189
"2011","Isles of Scilly","E06000053","Urban (total)",0,0,0,0,0,0,0,0,0
"2011","Isles of Scilly","E06000053","Urban major conurbation",0,0,0,0,0,0,0,0,0
"2011","Isles of Scilly","E06000053","Urban minor conurbation",0,0,0,0,0,0,0,0,0
"2011","Isles of Scilly","E06000053","Urban city and town",0,0,0,0,0,0,0,0,0
"2011","Isles of Scilly","E06000053","Urban city and town in a sparse setting",0,0,0,0,0,0,0,0,0
"2011","Isles of Scilly","E06000053","Rural (total)",989,249,2,247,196,76,208,19,189
"2011","Isles of Scilly","E06000053","Rural town and fringe",0,0,0,0,0,0,0,0,0
"2011","Isles of Scilly","E06000053","Rural town and fringe in a sparse setting",0,0,0,0,0,0,0,0,0
"2011","Isles of Scilly","E06000053","Rural village",0,0,0,0,0,0,0,0,0
"2011","Isles of Scilly","E06000053","Rural village in a sparse setting",935,238,2,236,183,69,201,17,184
"2011","Isles of Scilly","E06000053","Rural hamlet and isolated dwellings",0,0,0,0,0,0,0,0,0
"2011","Isles of Scilly","E06000053","Rural hamlet and isolated dwellings in a sparse setting",54,11,0,11,13,7,7,2,5
"2011","North Somerset","E06000024","Total",88227,31190,2507,28683,23916,9223,23372,3619,19753
"2011","North Somerset","E06000024","Urban (total)",72731,25933,2247,23686,19757,7725,19585,3064,16521
"2011","North Somerset","E06000024","Urban major conurbation",0,0,0,0,0,0,0,0,0
"2011","North Somerset","E06000024","Urban minor conurbation",0,0,0,0,0,0,0,0,0
"2011","North Somerset","E06000024","Urban city and town",72731,25933,2247,23686,19757,7725,19585,3064,16521
"2011","North Somerset","E06000024","Urban city and town in a sparse setting",0,0,0,0,0,0,0,0,0
"2011","North Somerset","E06000024","Rural (total)",15496,5257,260,4997,4159,1498,3787,555,3232
"2011","North Somerset","E06000024","Rural town and fringe",5783,2102,121,1981,1608,679,1429,223,1206
"2011","North Somerset","E06000024","Rural town and fringe in a sparse setting",0,0,0,0,0,0,0,0,0
"2011","North Somerset","E06000024","Rural village",6445,2166,84,2082,1702,550,1582,205,1377
"2011","North Somerset","E06000024","Rural village in a sparse setting",0,0,0,0,0,0,0,0,0
"2011","North Somerset","E06000024","Rural hamlet and isolated dwellings",3268,989,55,934,849,269,776,127,649
"2011","North Somerset","E06000024","Rural hamlet and isolated dwellings in a sparse setting",0,0,0,0,0,0,0,0,0
"2011","Plymouth","E06000026","Total",109307,39342,4747,34595,29510,12210,31164,5507,25657
"2011","Plymouth","E06000026","Urban (total)",109307,39342,4747,34595,29510,12210,31164,5507,25657
"2011","Plymouth","E06000026","Urban major conurbation",0,0,0,0,0,0,0,0,0
"2011","Plymouth","E06000026","Urban minor conurbation",0,0,0,0,0,0,0,0,0
"2011","Plymouth","E06000026","Urban city and town",109307,39342,4747,34595,29510,12210,31164,5507,25657
"2011","Plymouth","E06000026","Urban city and town in a sparse setting",0,0,0,0,0,0,0,0,0
"2011","Plymouth","E06000026","Rural (total)",0,0,0,0,0,0,0,0,0
"2011","Plymouth","E06000026","Rural town and fringe",0,0,0,0,0,0,0,0,0
"2011","Plymouth","E06000026","Rural town and fringe in a sparse setting",0,0,0,0,0,0,0,0,0
"2011","Plymouth","E06000026","Rural village",0,0,0,0,0,0,0,0,0
"2011","Plymouth","E06000026","Rural village in a sparse setting",0,0,0,0,0,0,0,0,0
"2011","Plymouth","E06000026","Rural hamlet and isolated dwellings",0,0,0,0,0,0,0,0,0
"2011","Plymouth","E06000026","Rural hamlet and isolated dwellings in a sparse setting",0,0,0,0,0,0,0,0,0
"2011","Poole","E06000029","Total",63530,22250,1835,20415,16685,6633,16536,2539,13997
"2011","Poole","E06000029","Urban (total)",63433,22224,1835,20389,16664,6630,16517,2537,13980
"2011","Poole","E06000029","Urban major conurbation",0,0,0,0,0,0,0,0,0
"2011","Poole","E06000029","Urban minor conurbation",0,0,0,0,0,0,0,0,0
"2011","Poole","E06000029","Urban city and town",63433,22224,1835,20389,16664,6630,16517,2537,13980
"2011","Poole","E06000029","Urban city and town in a sparse setting",0,0,0,0,0,0,0,0,0
"2011","Poole","E06000029","Rural (total)",97,26,0,26,21,3,19,2,17
"2011","Poole","E06000029","Rural town and fringe",0,0,0,0,0,0,0,0,0
"2011","Poole","E06000029","Rural town and fringe in a sparse setting",0,0,0,0,0,0,0,0,0
"2011","Poole","E06000029","Rural village",0,0,0,0,0,0,0,0,0
"2011","Poole","E06000029","Rural village in a sparse setting",0,0,0,0,0,0,0,0,0
"2011","Poole","E06000029","Rural hamlet and isolated dwellings",97,26,0,26,21,3,19,2,17
"2011","Poole","E06000029","Rural hamlet and isolated dwellings in a sparse setting",0,0,0,0,0,0,0,0,0
"2011","South Gloucestershire","E06000025","Total",107538,30967,2818,28149,32931,12546,24954,4652,20302
"2011","South Gloucestershire","E06000025","Urban (total)",94022,27103,2558,24545,28974,11322,21911,4108,17803
"2011","South Gloucestershire","E06000025","Urban major conurbation",0,0,0,0,0,0,0,0,0
"2011","South Gloucestershire","E06000025","Urban minor conurbation",0,0,0,0,0,0,0,0,0
"2011","South Gloucestershire","E06000025","Urban city and town",94022,27103,2558,24545,28974,11322,21911,4108,17803
"2011","South Gloucestershire","E06000025","Urban city and town in a sparse setting",0,0,0,0,0,0,0,0,0
"2011","South Gloucestershire","E06000025","Rural (total)",13516,3864,260,3604,3957,1224,3043,544,2499
"2011","South Gloucestershire","E06000025","Rural town and fringe",5591,1770,117,1653,1649,496,1354,219,1135
"2011","South Gloucestershire","E06000025","Rural town and fringe in a sparse setting",0,0,0,0,0,0,0,0,0
"2011","South Gloucestershire","E06000025","Rural village",4726,1323,88,1235,1432,445,1038,199,839
"2011","South Gloucestershire","E06000025","Rural village in a sparse setting",0,0,0,0,0,0,0,0,0
"2011","South Gloucestershire","E06000025","Rural hamlet and isolated dwellings",3199,771,55,716,876,283,651,126,525
"2011","South Gloucestershire","E06000025","Rural hamlet and isolated dwellings in a sparse setting",0,0,0,0,0,0,0,0,0
"2011","Swindon","E06000030","Total",88360,24712,3182,21530,27045,11266,20401,3912,16489
"2011","Swindon","E06000030","Urban (total)",78377,21500,2951,18549,24221,10325,17920,3498,14422
"2011","Swindon","E06000030","Urban major conurbation",0,0,0,0,0,0,0,0,0
"2011","Swindon","E06000030","Urban minor conurbation",0,0,0,0,0,0,0,0,0
"2011","Swindon","E06000030","Urban city and town",78377,21500,2951,18549,24221,10325,17920,3498,14422
"2011","Swindon","E06000030","Urban city and town in a sparse setting",0,0,0,0,0,0,0,0,0
"2011","Swindon","E06000030","Rural (total)",9983,3212,231,2981,2824,941,2481,414,2067
"2011","Swindon","E06000030","Rural town and fringe",8126,2813,192,2621,2203,727,2136,326,1810
"2011","Swindon","E06000030","Rural town and fringe in a sparse setting",0,0,0,0,0,0,0,0,0
"2011","Swindon","E06000030","Rural village",1267,273,33,240,440,161,246,67,179
"2011","Swindon","E06000030","Rural village in a sparse setting",0,0,0,0,0,0,0,0,0
"2011","Swindon","E06000030","Rural hamlet and isolated dwellings",590,126,6,120,181,53,99,21,78
"2011","Swindon","E06000030","Rural hamlet and isolated dwellings in a sparse setting",0,0,0,0,0,0,0,0,0
"2011","Torbay","E06000027","Total",59010,24994,2466,22528,14421,5329,18384,2773,15611
"2011","Torbay","E06000027","Urban (total)",58668,24856,2453,22403,14355,5306,18296,2758,15538
"2011","Torbay","E06000027","Urban major conurbation",0,0,0,0,0,0,0,0,0
"2011","Torbay","E06000027","Urban minor conurbation",0,0,0,0,0,0,0,0,0
"2011","Torbay","E06000027","Urban city and town",58668,24856,2453,22403,14355,5306,18296,2758,15538
"2011","Torbay","E06000027","Urban city and town in a sparse setting",0,0,0,0,0,0,0,0,0
"2011","Torbay","E06000027","Rural (total)",342,138,13,125,66,23,88,15,73
"2011","Torbay","E06000027","Rural town and fringe",0,0,0,0,0,0,0,0,0
"2011","Torbay","E06000027","Rural town and fringe in a sparse setting",0,0,0,0,0,0,0,0,0
"2011","Torbay","E06000027","Rural village",221,102,5,97,30,9,60,5,55
"2011","Torbay","E06000027","Rural village in a sparse setting",0,0,0,0,0,0,0,0,0
"2011","Torbay","E06000027","Rural hamlet and isolated dwellings",121,36,8,28,36,14,28,10,18
"2011","Torbay","E06000027","Rural hamlet and isolated dwellings in a sparse setting",0,0,0,0,0,0,0,0,0
"2011","Wiltshire","E06000054","Total",194194,58771,5266,53505,57751,22196,46425,8343,38082
"2011","Wiltshire","E06000054","Urban (total)",104506,32112,3496,28616,31674,12484,25756,4837,20919
"2011","Wiltshire","E06000054","Urban major conurbation",0,0,0,0,0,0,0,0,0
"2011","Wiltshire","E06000054","Urban minor conurbation",0,0,0,0,0,0,0,0,0
"2011","Wiltshire","E06000054","Urban city and town",104506,32112,3496,28616,31674,12484,25756,4837,20919
"2011","Wiltshire","E06000054","Urban city and town in a sparse setting",0,0,0,0,0,0,0,0,0
"2011","Wiltshire","E06000054","Rural (total)",89688,26659,1770,24889,26077,9712,20669,3506,17163
"2011","Wiltshire","E06000054","Rural town and fringe",36194,11339,898,10441,10724,4266,8841,1457,7384
"2011","Wiltshire","E06000054","Rural town and fringe in a sparse setting",0,0,0,0,0,0,0,0,0
"2011","Wiltshire","E06000054","Rural village",37808,11144,600,10544,10924,3960,8453,1450,7003
"2011","Wiltshire","E06000054","Rural village in a sparse setting",0,0,0,0,0,0,0,0,0
"2011","Wiltshire","E06000054","Rural hamlet and isolated dwellings",15686,4176,272,3904,4429,1486,3375,599,2776
"2011","Wiltshire","E06000054","Rural hamlet and isolated dwellings in a sparse setting",0,0,0,0,0,0,0,0,0
"2011","Devon","E10000008","Total",322644,118073,7612,110461,79781,29149,87039,12316,74723
"2011","Devon","E10000008","Urban (total)",157950,58191,4624,53567,39650,15682,43103,6150,36953
"2011","Devon","E10000008","Urban major conurbation",0,0,0,0,0,0,0,0,0
"2011","Devon","E10000008","Urban minor conurbation",0,0,0,0,0,0,0,0,0
"2011","Devon","E10000008","Urban city and town",153046,56325,4402,51923,38346,15146,41653,5939,35714
"2011","Devon","E10000008","Urban city and town in a sparse setting",4904,1866,222,1644,1304,536,1450,211,1239
"2011","Devon","E10000008","Rural (total)",164694,59882,2988,56894,40131,13467,43936,6166,37770
"2011","Devon","E10000008","Rural town and fringe",69636,27608,1514,26094,16863,5949,19505,2537,16968
"2011","Devon","E10000008","Rural town and fringe in a sparse setting",11308,4340,331,4009,2786,1107,3203,455,2748
"2011","Devon","E10000008","Rural village",33381,12262,492,11770,8096,2693,8693,1235,7458
"2011","Devon","E10000008","Rural village in a sparse setting",7346,2685,142,2543,1758,548,1992,302,1690
"2011","Devon","E10000008","Rural hamlet and isolated dwellings",31807,9471,378,9093,7979,2400,7578,1176,6402
"2011","Devon","E10000008","Rural hamlet and isolated dwellings in a sparse setting",11216,3516,131,3385,2649,770,2965,461,2504
"2011","Dorset","E10000009","Total",180213,70432,3838,66594,42924,15125,49924,6589,43335
"2011","Dorset","E10000009","Urban (total)",108730,43952,2486,41466,25933,9244,31028,4064,26964
"2011","Dorset","E10000009","Urban major conurbation",0,0,0,0,0,0,0,0,0
"2011","Dorset","E10000009","Urban minor conurbation",0,0,0,0,0,0,0,0,0
"2011","Dorset","E10000009","Urban city and town",108730,43952,2486,41466,25933,9244,31028,4064,26964
"2011","Dorset","E10000009","Urban city and town in a sparse setting",0,0,0,0,0,0,0,0,0
"2011","Dorset","E10000009","Rural (total)",71483,26480,1352,25128,16991,5881,18896,2525,16371
"2011","Dorset","E10000009","Rural town and fringe",31929,12756,787,11969,7598,2777,8959,1150,7809
"2011","Dorset","E10000009","Rural town and fringe in a sparse setting",131,90,0,90,6,1,49,1,48
"2011","Dorset","E10000009","Rural village",26334,9496,410,9086,6471,2222,6682,956,5726
"2011","Dorset","E10000009","Rural village in a sparse setting",0,0,0,0,0,0,0,0,0
"2011","Dorset","E10000009","Rural hamlet and isolated dwellings",13089,4138,155,3983,2916,881,3206,418,2788
"2011","Dorset","E10000009","Rural hamlet and isolated dwellings in a sparse setting",0,0,0,0,0,0,0,0,0
"2011","Gloucestershire","E10000013","Total",254615,80275,6318,73957,68475,26070,61708,9365,52343
"2011","Gloucestershire","E10000013","Urban (total)",179989,55926,5126,50800,49459,19688,43656,6867,36789
"2011","Gloucestershire","E10000013","Urban major conurbation",0,0,0,0,0,0,0,0,0
"2011","Gloucestershire","E10000013","Urban minor conurbation",0,0,0,0,0,0,0,0,0
"2011","Gloucestershire","E10000013","Urban city and town",179989,55926,5126,50800,49459,19688,43656,6867,36789
"2011","Gloucestershire","E10000013","Urban city and town in a sparse setting",0,0,0,0,0,0,0,0,0
"2011","Gloucestershire","E10000013","Rural (total)",74626,24349,1192,23157,19016,6382,18052,2498,15554
"2011","Gloucestershire","E10000013","Rural town and fringe",30435,11115,590,10525,7557,2715,8014,1048,6966
"2011","Gloucestershire","E10000013","Rural town and fringe in a sparse setting",0,0,0,0,0,0,0,0,0
"2011","Gloucestershire","E10000013","Rural village",28687,8689,405,8284,7751,2530,6605,987,5618
"2011","Gloucestershire","E10000013","Rural village in a sparse setting",0,0,0,0,0,0,0,0,0
"2011","Gloucestershire","E10000013","Rural hamlet and isolated dwellings",15504,4545,197,4348,3708,1137,3433,463,2970
"2011","Gloucestershire","E10000013","Rural hamlet and isolated dwellings in a sparse setting",0,0,0,0,0,0,0,0,0
"2011","Somerset","E10000027","Total",226989,79303,6071,73232,59753,22289,60057,8868,51189
"2011","Somerset","E10000027","Urban (total)",118731,41482,3960,37522,32460,13128,31620,4797,26823
"2011","Somerset","E10000027","Urban major conurbation",0,0,0,0,0,0,0,0,0
"2011","Somerset","E10000027","Urban minor conurbation",0,0,0,0,0,0,0,0,0
"2011","Somerset","E10000027","Urban city and town",113487,38964,3850,35114,31430,12732,29909,4625,25284
"2011","Somerset","E10000027","Urban city and town in a sparse setting",5244,2518,110,2408,1030,396,1711,172,1539
"2011","Somerset","E10000027","Rural (total)",108258,37821,2111,35710,27293,9161,28437,4071,24366
"2011","Somerset","E10000027","Rural town and fringe",43671,16224,1056,15168,11172,4133,12129,1664,10465
"2011","Somerset","E10000027","Rural town and fringe in a sparse setting",1020,537,27,510,175,72,331,32,299
"2011","Somerset","E10000027","Rural village",37822,13061,649,12412,9572,3029,9829,1432,8397
"2011","Somerset","E10000027","Rural village in a sparse setting",1158,572,25,547,184,52,399,44,355
"2011","Somerset","E10000027","Rural hamlet and isolated dwellings",22484,6673,323,6350,5807,1758,5192,824,4368
"2011","Somerset","E10000027","Rural hamlet and isolated dwellings in a sparse setting",2103,754,31,723,383,117,557,75,482
"2011","Anglesey","W06000001","Total",30594,12322,1100,11222,7764,3016,9398,1314,8084
"2011","Anglesey","W06000001","Urban (total)",5193,2280,321,1959,1470,609,1670,265,1405
"2011","Anglesey","W06000001","Urban major conurbation",0,0,0,0,0,0,0,0,0
"2011","Anglesey","W06000001","Urban minor conurbation",0,0,0,0,0,0,0,0,0
"2011","Anglesey","W06000001","Urban city and town",0,0,0,0,0,0,0,0,0
"2011","Anglesey","W06000001","Urban city and town in a sparse setting",5193,2280,321,1959,1470,609,1670,265,1405
"2011","Anglesey","W06000001","Rural (total)",25401,10042,779,9263,6294,2407,7728,1049,6679
"2011","Anglesey","W06000001","Rural town and fringe",5179,1904,162,1742,1333,514,1433,180,1253
"2011","Anglesey","W06000001","Rural town and fringe in a sparse setting",5671,2576,201,2375,1310,493,1857,236,1621
"2011","Anglesey","W06000001","Rural village",3579,1311,94,1217,914,342,1099,145,954
"2011","Anglesey","W06000001","Rural village in a sparse setting",6575,2643,228,2415,1682,675,2073,314,1759
"2011","Anglesey","W06000001","Rural hamlet and isolated dwellings",1188,437,16,421,266,80,341,44,297
"2011","Anglesey","W06000001","Rural hamlet and isolated dwellings in a sparse setting",3209,1171,78,1093,789,303,925,130,795
"2011","Gwynedd","W06000002","Total",52473,20333,1726,18607,13015,5219,15284,2124,13160
"2011","Gwynedd","W06000002","Urban (total)",5966,2411,297,2114,1490,603,1691,259,1432
"2011","Gwynedd","W06000002","Urban major conurbation",0,0,0,0,0,0,0,0,0
"2011","Gwynedd","W06000002","Urban minor conurbation",0,0,0,0,0,0,0,0,0
"2011","Gwynedd","W06000002","Urban city and town",5966,2411,297,2114,1490,603,1691,259,1432
"2011","Gwynedd","W06000002","Urban city and town in a sparse setting",0,0,0,0,0,0,0,0,0
"2011","Gwynedd","W06000002","Rural (total)",46507,17922,1429,16493,11525,4616,13593,1865,11728
"2011","Gwynedd","W06000002","Rural town and fringe",9189,3327,423,2904,2619,1147,2691,429,2262
"2011","Gwynedd","W06000002","Rural town and fringe in a sparse setting",12818,5515,375,5140,2792,1112,3858,435,3423
"2011","Gwynedd","W06000002","Rural village",4346,1386,118,1268,1309,509,1178,216,962
"2011","Gwynedd","W06000002","Rural village in a sparse setting",13344,5481,385,5096,3120,1200,4005,497,3508
"2011","Gwynedd","W06000002","Rural hamlet and isolated dwellings",1718,477,38,439,504,199,450,83,367
"2011","Gwynedd","W06000002","Rural hamlet and isolated dwellings in a sparse setting",5092,1736,90,1646,1181,449,1411,205,1206
"2011","Conwy","W06000003","Total",51177,21337,1746,19591,12516,4547,15797,2156,13641
"2011","Conwy","W06000003","Urban (total)",35604,15917,1306,14611,8559,3128,11320,1514,9806
"2011","Conwy","W06000003","Urban major conurbation",0,0,0,0,0,0,0,0,0
"2011","Conwy","W06000003","Urban minor conurbation",0,0,0,0,0,0,0,0,0
"2011","Conwy","W06000003","Urban city and town",35604,15917,1306,14611,8559,3128,11320,1514,9806
"2011","Conwy","W06000003","Urban city and town in a sparse setting",0,0,0,0,0,0,0,0,0
"2011","Conwy","W06000003","Rural (total)",15573,5420,440,4980,3957,1419,4477,642,3835
"2011","Conwy","W06000003","Rural town and fringe",6676,2483,225,2258,1751,614,1976,296,1680
"2011","Conwy","W06000003","Rural town and fringe in a sparse setting",1472,591,77,514,410,163,464,66,398
"2011","Conwy","W06000003","Rural village",2655,991,78,913,688,258,751,109,642
"2011","Conwy","W06000003","Rural village in a sparse setting",1075,347,22,325,227,83,289,32,257
"2011","Conwy","W06000003","Rural hamlet and isolated dwellings",2200,611,19,592,536,168,614,85,529
"2011","Conwy","W06000003","Rural hamlet and isolated dwellings in a sparse setting",1495,397,19,378,345,133,383,54,329
"2011","Denbighshire","W06000004","Total",40546,15941,1631,14310,11021,4164,12355,1973,10382
"2011","Denbighshire","W06000004","Urban (total)",20270,8902,1089,7813,5648,2226,6859,1154,5705
"2011","Denbighshire","W06000004","Urban major conurbation",0,0,0,0,0,0,0,0,0
"2011","Denbighshire","W06000004","Urban minor conurbation",0,0,0,0,0,0,0,0,0
"2011","Denbighshire","W06000004","Urban city and town",20270,8902,1089,7813,5648,2226,6859,1154,5705
"2011","Denbighshire","W06000004","Urban city and town in a sparse setting",0,0,0,0,0,0,0,0,0
"2011","Denbighshire","W06000004","Rural (total)",20276,7039,542,6497,5373,1938,5496,819,4677
"2011","Denbighshire","W06000004","Rural town and fringe",11192,4209,398,3811,3037,1173,3192,481,2711
"2011","Denbighshire","W06000004","Rural town and fringe in a sparse setting",0,0,0,0,0,0,0,0,0
"2011","Denbighshire","W06000004","Rural village",4561,1490,65,1425,1201,416,1200,169,1031
"2011","Denbighshire","W06000004","Rural village in a sparse setting",1199,386,32,354,303,93,315,53,262
"2011","Denbighshire","W06000004","Rural hamlet and isolated dwellings",3324,954,47,907,832,256,789,116,673
"2011","Denbighshire","W06000004","Rural hamlet and isolated dwellings in a sparse setting",0,0,0,0,0,0,0,0,0
"2011","Flintshire","W06000005","Total",63781,21392,2261,19131,18924,7373,17852,3088,14764
"2011","Flintshire","W06000005","Urban (total)",43972,14990,1846,13144,13435,5405,12588,2281,10307
"2011","Flintshire","W06000005","Urban major conurbation",0,0,0,0,0,0,0,0,0
"2011","Flintshire","W06000005","Urban minor conurbation",0,0,0,0,0,0,0,0,0
"2011","Flintshire","W06000005","Urban city and town",43972,14990,1846,13144,13435,5405,12588,2281,10307
"2011","Flintshire","W06000005","Urban city and town in a sparse setting",0,0,0,0,0,0,0,0,0
"2011","Flintshire","W06000005","Rural (total)",19809,6402,415,5987,5489,1968,5264,807,4457
"2011","Flintshire","W06000005","Rural town and fringe",8247,2654,202,2452,2460,912,2186,367,1819
"2011","Flintshire","W06000005","Rural town and fringe in a sparse setting",0,0,0,0,0,0,0,0,0
"2011","Flintshire","W06000005","Rural village",9027,3069,182,2887,2353,833,2455,339,2116
"2011","Flintshire","W06000005","Rural village in a sparse setting",0,0,0,0,0,0,0,0,0
"2011","Flintshire","W06000005","Rural hamlet and isolated dwellings",2535,679,31,648,676,223,623,101,522
"2011","Flintshire","W06000005","Rural hamlet and isolated dwellings in a sparse setting",0,0,0,0,0,0,0,0,0
"2011","Wrexham","W06000006","Total",57029,19852,2560,17292,17034,7103,16246,2913,13333
"2011","Wrexham","W06000006","Urban (total)",38740,14062,2100,11962,11798,5190,11440,2121,9319
"2011","Wrexham","W06000006","Urban major conurbation",0,0,0,0,0,0,0,0,0
"2011","Wrexham","W06000006","Urban minor conurbation",0,0,0,0,0,0,0,0,0
"2011","Wrexham","W06000006","Urban city and town",38740,14062,2100,11962,11798,5190,11440,2121,9319
"2011","Wrexham","W06000006","Urban city and town in a sparse setting",0,0,0,0,0,0,0,0,0
"2011","Wrexham","W06000006","Rural (total)",18289,5790,460,5330,5236,1913,4806,792,4014
"2011","Wrexham","W06000006","Rural town and fringe",10505,3493,300,3193,3011,1165,2882,471,2411
"2011","Wrexham","W06000006","Rural town and fringe in a sparse setting",0,0,0,0,0,0,0,0,0
"2011","Wrexham","W06000006","Rural village",4419,1360,99,1261,1302,466,1131,204,927
"2011","Wrexham","W06000006","Rural village in a sparse setting",0,0,0,0,0,0,0,0,0
"2011","Wrexham","W06000006","Rural hamlet and isolated dwellings",3242,895,52,843,885,265,750,109,641
"2011","Wrexham","W06000006","Rural hamlet and isolated dwellings in a sparse setting",123,42,9,33,38,17,43,8,35
"2011","Powys","W06000023","Total",58345,20867,1488,19379,14713,5157,17051,2410,14641
"2011","Powys","W06000023","Urban (total)",7994,3172,398,2774,2236,867,2637,439,2198
"2011","Powys","W06000023","Urban major conurbation",0,0,0,0,0,0,0,0,0
"2011","Powys","W06000023","Urban minor conurbation",0,0,0,0,0,0,0,0,0
"2011","Powys","W06000023","Urban city and town",2979,1373,116,1257,735,243,1160,158,1002
"2011","Powys","W06000023","Urban city and town in a sparse setting",5015,1799,282,1517,1501,624,1477,281,1196
"2011","Powys","W06000023","Rural (total)",50351,17695,1090,16605,12477,4290,14414,1971,12443
"2011","Powys","W06000023","Rural town and fringe",1416,608,26,582,305,103,454,49,405
"2011","Powys","W06000023","Rural town and fringe in a sparse setting",15765,6230,541,5689,3888,1469,4901,657,4244
"2011","Powys","W06000023","Rural village",4116,1442,87,1355,1109,345,1174,177,997
"2011","Powys","W06000023","Rural village in a sparse setting",13486,4860,250,4610,3361,1200,3865,491,3374
"2011","Powys","W06000023","Rural hamlet and isolated dwellings",1568,491,20,471,417,113,407,56,351
"2011","Powys","W06000023","Rural hamlet and isolated dwellings in a sparse setting",14000,4064,166,3898,3397,1060,3613,541,3072
"2011","Ceredigion","W06000008","Total",31562,12312,845,11467,7204,2708,9365,1288,8077
"2011","Ceredigion","W06000008","Urban (total)",6554,2627,144,2483,1182,483,1721,224,1497
"2011","Ceredigion","W06000008","Urban major conurbation",0,0,0,0,0,0,0,0,0
"2011","Ceredigion","W06000008","Urban minor conurbation",0,0,0,0,0,0,0,0,0
"2011","Ceredigion","W06000008","Urban city and town",0,0,0,0,0,0,0,0,0
"2011","Ceredigion","W06000008","Urban city and town in a sparse setting",6554,2627,144,2483,1182,483,1721,224,1497
"2011","Ceredigion","W06000008","Rural (total)",25008,9685,701,8984,6022,2225,7644,1064,6580
"2011","Ceredigion","W06000008","Rural town and fringe",0,0,0,0,0,0,0,0,0
"2011","Ceredigion","W06000008","Rural town and fringe in a sparse setting",5419,2536,232,2304,1152,472,1863,229,1634
"2011","Ceredigion","W06000008","Rural village",0,0,0,0,0,0,0,0,0
"2011","Ceredigion","W06000008","Rural village in a sparse setting",12030,4473,319,4154,3059,1142,3537,507,3030
"2011","Ceredigion","W06000008","Rural hamlet and isolated dwellings",0,0,0,0,0,0,0,0,0
"2011","Ceredigion","W06000008","Rural hamlet and isolated dwellings in a sparse setting",7559,2676,150,2526,1811,611,2244,328,1916
"2011","Pembrokeshire","W06000009","Total",53122,20782,2167,18615,14392,5266,15877,2603,13274
"2011","Pembrokeshire","W06000009","Urban (total)",12476,4967,702,4265,3659,1516,3870,703,3167
"2011","Pembrokeshire","W06000009","Urban major conurbation",0,0,0,0,0,0,0,0,0
"2011","Pembrokeshire","W06000009","Urban minor conurbation",0,0,0,0,0,0,0,0,0
"2011","Pembrokeshire","W06000009","Urban city and town",12476,4967,702,4265,3659,1516,3870,703,3167
"2011","Pembrokeshire","W06000009","Urban city and town in a sparse setting",0,0,0,0,0,0,0,0,0
"2011","Pembrokeshire","W06000009","Rural (total)",40646,15815,1465,14350,10733,3750,12007,1900,10107
"2011","Pembrokeshire","W06000009","Rural town and fringe",9429,3994,613,3381,2805,1063,2938,557,2381
"2011","Pembrokeshire","W06000009","Rural town and fringe in a sparse setting",8339,3690,274,3416,1877,703,2696,316,2380
"2011","Pembrokeshire","W06000009","Rural village",4485,1624,88,1536,1249,418,1197,199,998
"2011","Pembrokeshire","W06000009","Rural village in a sparse setting",8415,3255,251,3004,2184,746,2492,384,2108
"2011","Pembrokeshire","W06000009","Rural hamlet and isolated dwellings",2553,858,58,800,684,220,705,119,586
"2011","Pembrokeshire","W06000009","Rural hamlet and isolated dwellings in a sparse setting",7425,2394,181,2213,1934,600,1979,325,1654
"2011","Carmarthenshire","W06000010","Total",78829,31243,3526,27717,21840,8205,25479,4271,21208
"2011","Carmarthenshire","W06000010","Urban (total)",38481,15820,2042,13778,11188,4490,12590,2161,10429
"2011","Carmarthenshire","W06000010","Urban major conurbation",0,0,0,0,0,0,0,0,0
"2011","Carmarthenshire","W06000010","Urban minor conurbation",0,0,0,0,0,0,0,0,0
"2011","Carmarthenshire","W06000010","Urban city and town",31551,13084,1756,11328,9337,3745,10490,1848,8642
"2011","Carmarthenshire","W06000010","Urban city and town in a sparse setting",6930,2736,286,2450,1851,745,2100,313,1787
"2011","Carmarthenshire","W06000010","Rural (total)",40348,15423,1484,13939,10652,3715,12889,2110,10779
"2011","Carmarthenshire","W06000010","Rural town and fringe",11012,4787,563,4224,3049,1139,3780,630,3150
"2011","Carmarthenshire","W06000010","Rural town and fringe in a sparse setting",1827,771,86,685,465,180,592,80,512
"2011","Carmarthenshire","W06000010","Rural village",6550,2605,239,2366,1732,614,2165,328,1837
"2011","Carmarthenshire","W06000010","Rural village in a sparse setting",7043,2621,271,2350,1929,678,2237,391,1846
"2011","Carmarthenshire","W06000010","Rural hamlet and isolated dwellings",5963,2030,156,1874,1560,504,1766,299,1467
"2011","Carmarthenshire","W06000010","Rural hamlet and isolated dwellings in a sparse setting",7953,2609,169,2440,1917,600,2349,382,1967
"2011","Swansea","W06000011","Total",103497,41525,4979,36546,27695,10567,32178,5385,26793
"2011","Swansea","W06000011","Urban (total)",91551,37326,4693,32633,24259,9370,28827,4833,23994
"2011","Swansea","W06000011","Urban major conurbation",0,0,0,0,0,0,0,0,0
"2011","Swansea","W06000011","Urban minor conurbation",0,0,0,0,0,0,0,0,0
"2011","Swansea","W06000011","Urban city and town",91551,37326,4693,32633,24259,9370,28827,4833,23994
"2011","Swansea","W06000011","Urban city and town in a sparse setting",0,0,0,0,0,0,0,0,0
"2011","Swansea","W06000011","Rural (total)",11946,4199,286,3913,3436,1197,3351,552,2799
"2011","Swansea","W06000011","Rural town and fringe",5566,1965,164,1801,1685,608,1591,265,1326
"2011","Swansea","W06000011","Rural town and fringe in a sparse setting",0,0,0,0,0,0,0,0,0
"2011","Swansea","W06000011","Rural village",3605,1296,62,1234,966,334,995,143,852
"2011","Swansea","W06000011","Rural village in a sparse setting",0,0,0,0,0,0,0,0,0
"2011","Swansea","W06000011","Rural hamlet and isolated dwellings",2775,938,60,878,785,255,765,144,621
"2011","Swansea","W06000011","Rural hamlet and isolated dwellings in a sparse setting",0,0,0,0,0,0,0,0,0
"2011","Neath Port Talbot","W06000012","Total",60393,25161,3333,21828,17033,6178,21063,3659,17404
"2011","Neath Port Talbot","W06000012","Urban (total)",45966,19181,2536,16645,12879,4705,16126,2735,13391
"2011","Neath Port Talbot","W06000012","Urban major conurbation",0,0,0,0,0,0,0,0,0
"2011","Neath Port Talbot","W06000012","Urban minor conurbation",0,0,0,0,0,0,0,0,0
"2011","Neath Port Talbot","W06000012","Urban city and town",45966,19181,2536,16645,12879,4705,16126,2735,13391
"2011","Neath Port Talbot","W06000012","Urban city and town in a sparse setting",0,0,0,0,0,0,0,0,0
"2011","Neath Port Talbot","W06000012","Rural (total)",14427,5980,797,5183,4154,1473,4937,924,4013
"2011","Neath Port Talbot","W06000012","Rural town and fringe",9094,3939,543,3396,2618,934,3172,579,2593
"2011","Neath Port Talbot","W06000012","Rural town and fringe in a sparse setting",0,0,0,0,0,0,0,0,0
"2011","Neath Port Talbot","W06000012","Rural village",4258,1609,205,1404,1255,444,1397,279,1118
"2011","Neath Port Talbot","W06000012","Rural village in a sparse setting",0,0,0,0,0,0,0,0,0
"2011","Neath Port Talbot","W06000012","Rural hamlet and isolated dwellings",1075,432,49,383,281,95,368,66,302
"2011","Neath Port Talbot","W06000012","Rural hamlet and isolated dwellings in a sparse setting",0,0,0,0,0,0,0,0,0
"2011","Bridgend","W06000013","Total",58515,22591,2922,19669,17226,6266,18509,3391,15118
"2011","Bridgend","W06000013","Urban (total)",45426,17584,2250,15334,13387,4867,14202,2575,11627
"2011","Bridgend","W06000013","Urban major conurbation",0,0,0,0,0,0,0,0,0
"2011","Bridgend","W06000013","Urban minor conurbation",0,0,0,0,0,0,0,0,0
"2011","Bridgend","W06000013","Urban city and town",45426,17584,2250,15334,13387,4867,14202,2575,11627
"2011","Bridgend","W06000013","Urban city and town in a sparse setting",0,0,0,0,0,0,0,0,0
"2011","Bridgend","W06000013","Rural (total)",13089,5007,672,4335,3839,1399,4307,816,3491
"2011","Bridgend","W06000013","Rural town and fringe",9893,3818,509,3309,2938,1079,3238,598,2640
"2011","Bridgend","W06000013","Rural town and fringe in a sparse setting",0,0,0,0,0,0,0,0,0
"2011","Bridgend","W06000013","Rural village",2616,1036,147,889,727,276,910,179,731
"2011","Bridgend","W06000013","Rural village in a sparse setting",0,0,0,0,0,0,0,0,0
"2011","Bridgend","W06000013","Rural hamlet and isolated dwellings",580,153,16,137,174,44,159,39,120
"2011","Bridgend","W06000013","Rural hamlet and isolated dwellings in a sparse setting",0,0,0,0,0,0,0,0,0
"2011","The Vale of Glamorgan","W06000014","Total",53505,18923,2118,16805,15858,5890,15186,2693,12493
"2011","The Vale of Glamorgan","W06000014","Urban (total)",43388,15572,1962,13610,13103,5014,12690,2328,10362
"2011","The Vale of Glamorgan","W06000014","Urban major conurbation",0,0,0,0,0,0,0,0,0
"2011","The Vale of Glamorgan","W06000014","Urban minor conurbation",0,0,0,0,0,0,0,0,0
"2011","The Vale of Glamorgan","W06000014","Urban city and town",43388,15572,1962,13610,13103,5014,12690,2328,10362
"2011","The Vale of Glamorgan","W06000014","Urban city and town in a sparse setting",0,0,0,0,0,0,0,0,0
"2011","The Vale of Glamorgan","W06000014","Rural (total)",10117,3351,156,3195,2755,876,2496,365,2131
"2011","The Vale of Glamorgan","W06000014","Rural town and fringe",3866,1374,78,1296,1024,363,1072,157,915
"2011","The Vale of Glamorgan","W06000014","Rural town and fringe in a sparse setting",0,0,0,0,0,0,0,0,0
"2011","The Vale of Glamorgan","W06000014","Rural village",5469,1727,75,1652,1539,461,1237,185,1052
"2011","The Vale of Glamorgan","W06000014","Rural village in a sparse setting",0,0,0,0,0,0,0,0,0
"2011","The Vale of Glamorgan","W06000014","Rural hamlet and isolated dwellings",782,250,3,247,192,52,187,23,164
"2011","The Vale of Glamorgan","W06000014","Rural hamlet and isolated dwellings in a sparse setting",0,0,0,0,0,0,0,0,0
"2011","Cardiff","W06000015","Total",142557,48007,7376,40631,39508,17383,37719,7063,30656
"2011","Cardiff","W06000015","Urban (total)",140235,47369,7334,40035,38738,17154,37185,6959,30226
"2011","Cardiff","W06000015","Urban major conurbation",0,0,0,0,0,0,0,0,0
"2011","Cardiff","W06000015","Urban minor conurbation",0,0,0,0,0,0,0,0,0
"2011","Cardiff","W06000015","Urban city and town",140235,47369,7334,40035,38738,17154,37185,6959,30226
"2011","Cardiff","W06000015","Urban city and town in a sparse setting",0,0,0,0,0,0,0,0,0
"2011","Cardiff","W06000015","Rural (total)",2322,638,42,596,770,229,534,104,430
"2011","Cardiff","W06000015","Rural town and fringe",1871,542,39,503,597,175,441,81,360
"2011","Cardiff","W06000015","Rural town and fringe in a sparse setting",0,0,0,0,0,0,0,0,0
"2011","Cardiff","W06000015","Rural village",451,96,3,93,173,54,93,23,70
"2011","Cardiff","W06000015","Rural village in a sparse setting",0,0,0,0,0,0,0,0,0
"2011","Cardiff","W06000015","Rural hamlet and isolated dwellings",0,0,0,0,0,0,0,0,0
"2011","Cardiff","W06000015","Rural hamlet and isolated dwellings in a sparse setting",0,0,0,0,0,0,0,0,0
"2011","Rhondda, Cynon, Taff","W06000016","Total",99663,40356,5978,34378,29963,11730,32820,6069,26751
"2011","Rhondda, Cynon, Taff","W06000016","Urban (total)",75029,30363,4282,26081,22119,8657,24505,4379,20126
"2011","Rhondda, Cynon, Taff","W06000016","Urban major conurbation",0,0,0,0,0,0,0,0,0
"2011","Rhondda, Cynon, Taff","W06000016","Urban minor conurbation",0,0,0,0,0,0,0,0,0
"2011","Rhondda, Cynon, Taff","W06000016","Urban city and town",75029,30363,4282,26081,22119,8657,24505,4379,20126
"2011","Rhondda, Cynon, Taff","W06000016","Urban city and town in a sparse setting",0,0,0,0,0,0,0,0,0
"2011","Rhondda, Cynon, Taff","W06000016","Rural (total)",24634,9993,1696,8297,7844,3073,8315,1690,6625
"2011","Rhondda, Cynon, Taff","W06000016","Rural town and fringe",21762,8871,1574,7297,7079,2822,7404,1523,5881
"2011","Rhondda, Cynon, Taff","W06000016","Rural town and fringe in a sparse setting",0,0,0,0,0,0,0,0,0
"2011","Rhondda, Cynon, Taff","W06000016","Rural village",1526,656,56,600,360,114,525,82,443
"2011","Rhondda, Cynon, Taff","W06000016","Rural village in a sparse setting",0,0,0,0,0,0,0,0,0
"2011","Rhondda, Cynon, Taff","W06000016","Rural hamlet and isolated dwellings",1346,466,66,400,405,137,386,85,301
"2011","Rhondda, Cynon, Taff","W06000016","Rural hamlet and isolated dwellings in a sparse setting",0,0,0,0,0,0,0,0,0
"2011","Merthyr Tydfil","W06000024","Total",24264,9550,1528,8022,7654,2978,8299,1675,6624
"2011","Merthyr Tydfil","W06000024","Urban (total)",21182,8252,1326,6926,6741,2649,7171,1459,5712
"2011","Merthyr Tydfil","W06000024","Urban major conurbation",0,0,0,0,0,0,0,0,0
"2011","Merthyr Tydfil","W06000024","Urban minor conurbation",0,0,0,0,0,0,0,0,0
"2011","Merthyr Tydfil","W06000024","Urban city and town",21182,8252,1326,6926,6741,2649,7171,1459,5712
"2011","Merthyr Tydfil","W06000024","Urban city and town in a sparse setting",0,0,0,0,0,0,0,0,0
"2011","Merthyr Tydfil","W06000024","Rural (total)",3082,1298,202,1096,913,329,1128,216,912
"2011","Merthyr Tydfil","W06000024","Rural town and fringe",2739,1171,189,982,829,302,1015,196,819
"2011","Merthyr Tydfil","W06000024","Rural town and fringe in a sparse setting",0,0,0,0,0,0,0,0,0
"2011","Merthyr Tydfil","W06000024","Rural village",242,90,11,79,66,21,77,16,61
"2011","Merthyr Tydfil","W06000024","Rural village in a sparse setting",0,0,0,0,0,0,0,0,0
"2011","Merthyr Tydfil","W06000024","Rural hamlet and isolated dwellings",101,37,2,35,18,6,36,4,32
"2011","Merthyr Tydfil","W06000024","Rural hamlet and isolated dwellings in a sparse setting",0,0,0,0,0,0,0,0,0
"2011","Caerphilly","W06000018","Total",74479,28643,4497,24146,23550,9133,23979,4888,19091
"2011","Caerphilly","W06000018","Urban (total)",58401,22134,3326,18808,18389,7098,18655,3795,14860
"2011","Caerphilly","W06000018","Urban major conurbation",0,0,0,0,0,0,0,0,0
"2011","Caerphilly","W06000018","Urban minor conurbation",0,0,0,0,0,0,0,0,0
"2011","Caerphilly","W06000018","Urban city and town",58401,22134,3326,18808,18389,7098,18655,3795,14860
"2011","Caerphilly","W06000018","Urban city and town in a sparse setting",0,0,0,0,0,0,0,0,0
"2011","Caerphilly","W06000018","Rural (total)",16078,6509,1171,5338,5161,2035,5324,1093,4231
"2011","Caerphilly","W06000018","Rural town and fringe",13150,5567,1036,4531,4232,1691,4485,901,3584
"2011","Caerphilly","W06000018","Rural town and fringe in a sparse setting",0,0,0,0,0,0,0,0,0
"2011","Caerphilly","W06000018","Rural village",2469,791,115,676,793,291,706,164,542
"2011","Caerphilly","W06000018","Rural village in a sparse setting",0,0,0,0,0,0,0,0,0
"2011","Caerphilly","W06000018","Rural hamlet and isolated dwellings",459,151,20,131,136,53,133,28,105
"2011","Caerphilly","W06000018","Rural hamlet and isolated dwellings in a sparse setting",0,0,0,0,0,0,0,0,0
"2011","Blaenau Gwent","W06000019","Total",30416,13304,2076,11228,8853,3328,10506,1816,8690
"2011","Blaenau Gwent","W06000019","Urban (total)",26315,11619,1792,9827,7634,2843,9115,1561,7554
"2011","Blaenau Gwent","W06000019","Urban major conurbation",0,0,0,0,0,0,0,0,0
"2011","Blaenau Gwent","W06000019","Urban minor conurbation",0,0,0,0,0,0,0,0,0
"2011","Blaenau Gwent","W06000019","Urban city and town",26315,11619,1792,9827,7634,2843,9115,1561,7554
"2011","Blaenau Gwent","W06000019","Urban city and town in a sparse setting",0,0,0,0,0,0,0,0,0
"2011","Blaenau Gwent","W06000019","Rural (total)",4101,1685,284,1401,1219,485,1391,255,1136
"2011","Blaenau Gwent","W06000019","Rural town and fringe",3200,1379,221,1158,935,367,1134,204,930
"2011","Blaenau Gwent","W06000019","Rural town and fringe in a sparse setting",0,0,0,0,0,0,0,0,0
"2011","Blaenau Gwent","W06000019","Rural village",516,195,50,145,160,73,141,28,113
"2011","Blaenau Gwent","W06000019","Rural village in a sparse setting",0,0,0,0,0,0,0,0,0
"2011","Blaenau Gwent","W06000019","Rural hamlet and isolated dwellings",385,111,13,98,124,45,116,23,93
"2011","Blaenau Gwent","W06000019","Rural hamlet and isolated dwellings in a sparse setting",0,0,0,0,0,0,0,0,0
"2011","Torfaen","W06000020","Total",38524,14963,1965,12998,11633,4361,12223,2255,9968
"2011","Torfaen","W06000020","Urban (total)",34962,13483,1774,11709,10592,3970,11087,2061,9026
"2011","Torfaen","W06000020","Urban major conurbation",0,0,0,0,0,0,0,0,0
"2011","Torfaen","W06000020","Urban minor conurbation",0,0,0,0,0,0,0,0,0
"2011","Torfaen","W06000020","Urban city and town",34962,13483,1774,11709,10592,3970,11087,2061,9026
"2011","Torfaen","W06000020","Urban city and town in a sparse setting",0,0,0,0,0,0,0,0,0
"2011","Torfaen","W06000020","Rural (total)",3562,1480,191,1289,1041,391,1136,194,942
"2011","Torfaen","W06000020","Rural town and fringe",3040,1297,152,1145,871,327,970,156,814
"2011","Torfaen","W06000020","Rural town and fringe in a sparse setting",0,0,0,0,0,0,0,0,0
"2011","Torfaen","W06000020","Rural village",223,90,22,68,77,26,71,15,56
"2011","Torfaen","W06000020","Rural village in a sparse setting",0,0,0,0,0,0,0,0,0
"2011","Torfaen","W06000020","Rural hamlet and isolated dwellings",299,93,17,76,93,38,95,23,72
"2011","Torfaen","W06000020","Rural hamlet and isolated dwellings in a sparse setting",0,0,0,0,0,0,0,0,0
"2011","Monmouthshire","W06000021","Total",38233,13451,984,12467,10641,3637,10901,1640,9261
"2011","Monmouthshire","W06000021","Urban (total)",20846,7961,719,7242,5779,2157,6329,955,5374
"2011","Monmouthshire","W06000021","Urban major conurbation",0,0,0,0,0,0,0,0,0
"2011","Monmouthshire","W06000021","Urban minor conurbation",0,0,0,0,0,0,0,0,0
"2011","Monmouthshire","W06000021","Urban city and town",20846,7961,719,7242,5779,2157,6329,955,5374
"2011","Monmouthshire","W06000021","Urban city and town in a sparse setting",0,0,0,0,0,0,0,0,0
"2011","Monmouthshire","W06000021","Rural (total)",17387,5490,265,5225,4862,1480,4572,685,3887
"2011","Monmouthshire","W06000021","Rural town and fringe",6876,2381,128,2253,2021,644,1910,298,1612
"2011","Monmouthshire","W06000021","Rural town and fringe in a sparse setting",0,0,0,0,0,0,0,0,0
"2011","Monmouthshire","W06000021","Rural village",4381,1422,62,1360,1170,351,1162,157,1005
"2011","Monmouthshire","W06000021","Rural village in a sparse setting",0,0,0,0,0,0,0,0,0
"2011","Monmouthshire","W06000021","Rural hamlet and isolated dwellings",6130,1687,75,1612,1671,485,1500,230,1270
"2011","Monmouthshire","W06000021","Rural hamlet and isolated dwellings in a sparse setting",0,0,0,0,0,0,0,0,0
"2011","Newport","W06000022","Total",61172,22854,3466,19388,18943,7596,17796,3405,14391
"2011","Newport","W06000022","Urban (total)",53866,20482,3281,17201,16823,6919,15852,3050,12802
"2011","Newport","W06000022","Urban major conurbation",0,0,0,0,0,0,0,0,0
"2011","Newport","W06000022","Urban minor conurbation",0,0,0,0,0,0,0,0,0
"2011","Newport","W06000022","Urban city and town",53866,20482,3281,17201,16823,6919,15852,3050,12802
"2011","Newport","W06000022","Urban city and town in a sparse setting",0,0,0,0,0,0,0,0,0
"2011","Newport","W06000022","Rural (total)",7306,2372,185,2187,2120,677,1944,355,1589
"2011","Newport","W06000022","Rural town and fringe",5171,1670,156,1514,1588,519,1362,263,1099
"2011","Newport","W06000022","Rural town and fringe in a sparse setting",0,0,0,0,0,0,0,0,0
"2011","Newport","W06000022","Rural village",1659,576,27,549,393,122,468,70,398
"2011","Newport","W06000022","Rural village in a sparse setting",0,0,0,0,0,0,0,0,0
"2011","Newport","W06000022","Rural hamlet and isolated dwellings",476,126,2,124,139,36,114,22,92
"2011","Newport","W06000022","Rural hamlet and isolated dwellings in a sparse setting",0,0,0,0,0,0,0,0,0

