"date","geography","geography code","Rural Urban","Residence Type: All categories: Residence type; measures: Value","Residence Type: Lives in a household; measures: Value","Residence Type: Lives in a communal establishment; measures: Value","Residence Type: Communal establishments with persons sleeping rough identified; measures: Value"
"2011","Darlington","E06000005","Total",105564,104111,1453,0
"2011","Darlington","E06000005","Urban (total)",92363,91122,1241,0
"2011","Darlington","E06000005","Urban major conurbation",0,0,0,0
"2011","Darlington","E06000005","Urban minor conurbation",0,0,0,0
"2011","Darlington","E06000005","Urban city and town",92363,91122,1241,0
"2011","Darlington","E06000005","Urban city and town in a sparse setting",0,0,0,0
"2011","Darlington","E06000005","Rural (total)",13201,12989,212,0
"2011","Darlington","E06000005","Rural town and fringe",7770,7747,23,0
"2011","Darlington","E06000005","Rural town and fringe in a sparse setting",0,0,0,0
"2011","Darlington","E06000005","Rural village",3742,3553,189,0
"2011","Darlington","E06000005","Rural village in a sparse setting",0,0,0,0
"2011","Darlington","E06000005","Rural hamlet and isolated dwellings",1689,1689,0,0
"2011","Darlington","E06000005","Rural hamlet and isolated dwellings in a sparse setting",0,0,0,0
"2011","County Durham","E06000047","Total",513242,500288,12954,8
"2011","County Durham","E06000047","Urban (total)",281825,271702,10123,3
"2011","County Durham","E06000047","Urban major conurbation",39407,39097,310,0
"2011","County Durham","E06000047","Urban minor conurbation",0,0,0,0
"2011","County Durham","E06000047","Urban city and town",242418,232605,9813,3
"2011","County Durham","E06000047","Urban city and town in a sparse setting",0,0,0,0
"2011","County Durham","E06000047","Rural (total)",231417,228586,2831,5
"2011","County Durham","E06000047","Rural town and fringe",177952,176056,1896,1
"2011","County Durham","E06000047","Rural town and fringe in a sparse setting",244,243,1,0
"2011","County Durham","E06000047","Rural village",33544,33315,229,2
"2011","County Durham","E06000047","Rural village in a sparse setting",2424,2419,5,0
"2011","County Durham","E06000047","Rural hamlet and isolated dwellings",15348,14654,694,1
"2011","County Durham","E06000047","Rural hamlet and isolated dwellings in a sparse setting",1905,1899,6,1
"2011","Hartlepool","E06000001","Total",92028,91091,937,0
"2011","Hartlepool","E06000001","Urban (total)",88855,87992,863,0
"2011","Hartlepool","E06000001","Urban major conurbation",0,0,0,0
"2011","Hartlepool","E06000001","Urban minor conurbation",0,0,0,0
"2011","Hartlepool","E06000001","Urban city and town",88855,87992,863,0
"2011","Hartlepool","E06000001","Urban city and town in a sparse setting",0,0,0,0
"2011","Hartlepool","E06000001","Rural (total)",3173,3099,74,0
"2011","Hartlepool","E06000001","Rural town and fringe",742,742,0,0
"2011","Hartlepool","E06000001","Rural town and fringe in a sparse setting",0,0,0,0
"2011","Hartlepool","E06000001","Rural village",1539,1539,0,0
"2011","Hartlepool","E06000001","Rural village in a sparse setting",0,0,0,0
"2011","Hartlepool","E06000001","Rural hamlet and isolated dwellings",892,818,74,0
"2011","Hartlepool","E06000001","Rural hamlet and isolated dwellings in a sparse setting",0,0,0,0
"2011","Middlesbrough","E06000002","Total",138412,136156,2256,0
"2011","Middlesbrough","E06000002","Urban (total)",137455,135218,2237,0
"2011","Middlesbrough","E06000002","Urban major conurbation",0,0,0,0
"2011","Middlesbrough","E06000002","Urban minor conurbation",0,0,0,0
"2011","Middlesbrough","E06000002","Urban city and town",137455,135218,2237,0
"2011","Middlesbrough","E06000002","Urban city and town in a sparse setting",0,0,0,0
"2011","Middlesbrough","E06000002","Rural (total)",957,938,19,0
"2011","Middlesbrough","E06000002","Rural town and fringe",592,592,0,0
"2011","Middlesbrough","E06000002","Rural town and fringe in a sparse setting",0,0,0,0
"2011","Middlesbrough","E06000002","Rural village",365,346,19,0
"2011","Middlesbrough","E06000002","Rural village in a sparse setting",0,0,0,0
"2011","Middlesbrough","E06000002","Rural hamlet and isolated dwellings",0,0,0,0
"2011","Middlesbrough","E06000002","Rural hamlet and isolated dwellings in a sparse setting",0,0,0,0
"2011","Northumberland","E06000048","Total",316028,310591,5437,1
"2011","Northumberland","E06000048","Urban (total)",170932,168670,2262,0
"2011","Northumberland","E06000048","Urban major conurbation",26699,26468,231,0
"2011","Northumberland","E06000048","Urban minor conurbation",0,0,0,0
"2011","Northumberland","E06000048","Urban city and town",130968,129264,1704,0
"2011","Northumberland","E06000048","Urban city and town in a sparse setting",13265,12938,327,0
"2011","Northumberland","E06000048","Rural (total)",145096,141921,3175,1
"2011","Northumberland","E06000048","Rural town and fringe",53488,51966,1522,0
"2011","Northumberland","E06000048","Rural town and fringe in a sparse setting",28831,28483,348,0
"2011","Northumberland","E06000048","Rural village",12880,12566,314,0
"2011","Northumberland","E06000048","Rural village in a sparse setting",16991,16869,122,1
"2011","Northumberland","E06000048","Rural hamlet and isolated dwellings",15983,15529,454,0
"2011","Northumberland","E06000048","Rural hamlet and isolated dwellings in a sparse setting",16923,16508,415,0
"2011","Redcar and Cleveland","E06000003","Total",135177,133929,1248,0
"2011","Redcar and Cleveland","E06000003","Urban (total)",91297,90532,765,0
"2011","Redcar and Cleveland","E06000003","Urban major conurbation",0,0,0,0
"2011","Redcar and Cleveland","E06000003","Urban minor conurbation",0,0,0,0
"2011","Redcar and Cleveland","E06000003","Urban city and town",91297,90532,765,0
"2011","Redcar and Cleveland","E06000003","Urban city and town in a sparse setting",0,0,0,0
"2011","Redcar and Cleveland","E06000003","Rural (total)",43880,43397,483,0
"2011","Redcar and Cleveland","E06000003","Rural town and fringe",38785,38396,389,0
"2011","Redcar and Cleveland","E06000003","Rural town and fringe in a sparse setting",0,0,0,0
"2011","Redcar and Cleveland","E06000003","Rural village",3136,3073,63,0
"2011","Redcar and Cleveland","E06000003","Rural village in a sparse setting",0,0,0,0
"2011","Redcar and Cleveland","E06000003","Rural hamlet and isolated dwellings",1959,1928,31,0
"2011","Redcar and Cleveland","E06000003","Rural hamlet and isolated dwellings in a sparse setting",0,0,0,0
"2011","Stockton-on-Tees","E06000004","Total",191610,187959,3651,1
"2011","Stockton-on-Tees","E06000004","Urban (total)",184074,180512,3562,1
"2011","Stockton-on-Tees","E06000004","Urban major conurbation",0,0,0,0
"2011","Stockton-on-Tees","E06000004","Urban minor conurbation",0,0,0,0
"2011","Stockton-on-Tees","E06000004","Urban city and town",184074,180512,3562,1
"2011","Stockton-on-Tees","E06000004","Urban city and town in a sparse setting",0,0,0,0
"2011","Stockton-on-Tees","E06000004","Rural (total)",7536,7447,89,0
"2011","Stockton-on-Tees","E06000004","Rural town and fringe",392,392,0,0
"2011","Stockton-on-Tees","E06000004","Rural town and fringe in a sparse setting",0,0,0,0
"2011","Stockton-on-Tees","E06000004","Rural village",5961,5880,81,0
"2011","Stockton-on-Tees","E06000004","Rural village in a sparse setting",0,0,0,0
"2011","Stockton-on-Tees","E06000004","Rural hamlet and isolated dwellings",1183,1175,8,0
"2011","Stockton-on-Tees","E06000004","Rural hamlet and isolated dwellings in a sparse setting",0,0,0,0
"2011","Gateshead","E08000020","Total",200214,197726,2488,1
"2011","Gateshead","E08000020","Urban (total)",184151,181753,2398,1
"2011","Gateshead","E08000020","Urban major conurbation",181290,178894,2396,1
"2011","Gateshead","E08000020","Urban minor conurbation",0,0,0,0
"2011","Gateshead","E08000020","Urban city and town",2861,2859,2,0
"2011","Gateshead","E08000020","Urban city and town in a sparse setting",0,0,0,0
"2011","Gateshead","E08000020","Rural (total)",16063,15973,90,0
"2011","Gateshead","E08000020","Rural town and fringe",12883,12810,73,0
"2011","Gateshead","E08000020","Rural town and fringe in a sparse setting",0,0,0,0
"2011","Gateshead","E08000020","Rural village",1560,1560,0,0
"2011","Gateshead","E08000020","Rural village in a sparse setting",0,0,0,0
"2011","Gateshead","E08000020","Rural hamlet and isolated dwellings",1620,1603,17,0
"2011","Gateshead","E08000020","Rural hamlet and isolated dwellings in a sparse setting",0,0,0,0
"2011","Newcastle upon Tyne","E08000021","Total",280177,271212,8965,5
"2011","Newcastle upon Tyne","E08000021","Urban (total)",274444,265534,8910,5
"2011","Newcastle upon Tyne","E08000021","Urban major conurbation",273861,264951,8910,5
"2011","Newcastle upon Tyne","E08000021","Urban minor conurbation",0,0,0,0
"2011","Newcastle upon Tyne","E08000021","Urban city and town",583,583,0,0
"2011","Newcastle upon Tyne","E08000021","Urban city and town in a sparse setting",0,0,0,0
"2011","Newcastle upon Tyne","E08000021","Rural (total)",5733,5678,55,0
"2011","Newcastle upon Tyne","E08000021","Rural town and fringe",4043,4021,22,0
"2011","Newcastle upon Tyne","E08000021","Rural town and fringe in a sparse setting",0,0,0,0
"2011","Newcastle upon Tyne","E08000021","Rural village",1690,1657,33,0
"2011","Newcastle upon Tyne","E08000021","Rural village in a sparse setting",0,0,0,0
"2011","Newcastle upon Tyne","E08000021","Rural hamlet and isolated dwellings",0,0,0,0
"2011","Newcastle upon Tyne","E08000021","Rural hamlet and isolated dwellings in a sparse setting",0,0,0,0
"2011","North Tyneside","E08000022","Total",200801,199142,1659,0
"2011","North Tyneside","E08000022","Urban (total)",192278,190668,1610,0
"2011","North Tyneside","E08000022","Urban major conurbation",190512,188905,1607,0
"2011","North Tyneside","E08000022","Urban minor conurbation",0,0,0,0
"2011","North Tyneside","E08000022","Urban city and town",1766,1763,3,0
"2011","North Tyneside","E08000022","Urban city and town in a sparse setting",0,0,0,0
"2011","North Tyneside","E08000022","Rural (total)",8523,8474,49,0
"2011","North Tyneside","E08000022","Rural town and fringe",7895,7846,49,0
"2011","North Tyneside","E08000022","Rural town and fringe in a sparse setting",0,0,0,0
"2011","North Tyneside","E08000022","Rural village",297,297,0,0
"2011","North Tyneside","E08000022","Rural village in a sparse setting",0,0,0,0
"2011","North Tyneside","E08000022","Rural hamlet and isolated dwellings",331,331,0,0
"2011","North Tyneside","E08000022","Rural hamlet and isolated dwellings in a sparse setting",0,0,0,0
"2011","South Tyneside","E08000023","Total",148127,146729,1398,0
"2011","South Tyneside","E08000023","Urban (total)",147526,146128,1398,0
"2011","South Tyneside","E08000023","Urban major conurbation",141543,140145,1398,0
"2011","South Tyneside","E08000023","Urban minor conurbation",0,0,0,0
"2011","South Tyneside","E08000023","Urban city and town",5983,5983,0,0
"2011","South Tyneside","E08000023","Urban city and town in a sparse setting",0,0,0,0
"2011","South Tyneside","E08000023","Rural (total)",601,601,0,0
"2011","South Tyneside","E08000023","Rural town and fringe",327,327,0,0
"2011","South Tyneside","E08000023","Rural town and fringe in a sparse setting",0,0,0,0
"2011","South Tyneside","E08000023","Rural village",0,0,0,0
"2011","South Tyneside","E08000023","Rural village in a sparse setting",0,0,0,0
"2011","South Tyneside","E08000023","Rural hamlet and isolated dwellings",274,274,0,0
"2011","South Tyneside","E08000023","Rural hamlet and isolated dwellings in a sparse setting",0,0,0,0
"2011","Sunderland","E08000024","Total",275506,271884,3622,1
"2011","Sunderland","E08000024","Urban (total)",274013,270391,3622,1
"2011","Sunderland","E08000024","Urban major conurbation",273097,269475,3622,1
"2011","Sunderland","E08000024","Urban minor conurbation",0,0,0,0
"2011","Sunderland","E08000024","Urban city and town",916,916,0,0
"2011","Sunderland","E08000024","Urban city and town in a sparse setting",0,0,0,0
"2011","Sunderland","E08000024","Rural (total)",1493,1493,0,0
"2011","Sunderland","E08000024","Rural town and fringe",1213,1213,0,0
"2011","Sunderland","E08000024","Rural town and fringe in a sparse setting",0,0,0,0
"2011","Sunderland","E08000024","Rural village",0,0,0,0
"2011","Sunderland","E08000024","Rural village in a sparse setting",0,0,0,0
"2011","Sunderland","E08000024","Rural hamlet and isolated dwellings",280,280,0,0
"2011","Sunderland","E08000024","Rural hamlet and isolated dwellings in a sparse setting",0,0,0,0
"2011","Blackburn with Darwen","E06000008","Total",147489,145827,1662,0
"2011","Blackburn with Darwen","E06000008","Urban (total)",140558,138896,1662,0
"2011","Blackburn with Darwen","E06000008","Urban major conurbation",0,0,0,0
"2011","Blackburn with Darwen","E06000008","Urban minor conurbation",0,0,0,0
"2011","Blackburn with Darwen","E06000008","Urban city and town",140558,138896,1662,0
"2011","Blackburn with Darwen","E06000008","Urban city and town in a sparse setting",0,0,0,0
"2011","Blackburn with Darwen","E06000008","Rural (total)",6931,6931,0,0
"2011","Blackburn with Darwen","E06000008","Rural town and fringe",2612,2612,0,0
"2011","Blackburn with Darwen","E06000008","Rural town and fringe in a sparse setting",0,0,0,0
"2011","Blackburn with Darwen","E06000008","Rural village",2378,2378,0,0
"2011","Blackburn with Darwen","E06000008","Rural village in a sparse setting",0,0,0,0
"2011","Blackburn with Darwen","E06000008","Rural hamlet and isolated dwellings",1941,1941,0,0
"2011","Blackburn with Darwen","E06000008","Rural hamlet and isolated dwellings in a sparse setting",0,0,0,0
"2011","Blackpool","E06000009","Total",142065,137960,4105,4
"2011","Blackpool","E06000009","Urban (total)",141510,137405,4105,4
"2011","Blackpool","E06000009","Urban major conurbation",0,0,0,0
"2011","Blackpool","E06000009","Urban minor conurbation",0,0,0,0
"2011","Blackpool","E06000009","Urban city and town",141510,137405,4105,4
"2011","Blackpool","E06000009","Urban city and town in a sparse setting",0,0,0,0
"2011","Blackpool","E06000009","Rural (total)",555,555,0,0
"2011","Blackpool","E06000009","Rural town and fringe",555,555,0,0
"2011","Blackpool","E06000009","Rural town and fringe in a sparse setting",0,0,0,0
"2011","Blackpool","E06000009","Rural village",0,0,0,0
"2011","Blackpool","E06000009","Rural village in a sparse setting",0,0,0,0
"2011","Blackpool","E06000009","Rural hamlet and isolated dwellings",0,0,0,0
"2011","Blackpool","E06000009","Rural hamlet and isolated dwellings in a sparse setting",0,0,0,0
"2011","Cheshire East","E06000049","Total",370127,365065,5062,0
"2011","Cheshire East","E06000049","Urban (total)",299520,296980,2540,0
"2011","Cheshire East","E06000049","Urban major conurbation",45501,45109,392,0
"2011","Cheshire East","E06000049","Urban minor conurbation",0,0,0,0
"2011","Cheshire East","E06000049","Urban city and town",254019,251871,2148,0
"2011","Cheshire East","E06000049","Urban city and town in a sparse setting",0,0,0,0
"2011","Cheshire East","E06000049","Rural (total)",70607,68085,2522,0
"2011","Cheshire East","E06000049","Rural town and fringe",20733,20488,245,0
"2011","Cheshire East","E06000049","Rural town and fringe in a sparse setting",0,0,0,0
"2011","Cheshire East","E06000049","Rural village",21405,21142,263,0
"2011","Cheshire East","E06000049","Rural village in a sparse setting",0,0,0,0
"2011","Cheshire East","E06000049","Rural hamlet and isolated dwellings",28469,26455,2014,0
"2011","Cheshire East","E06000049","Rural hamlet and isolated dwellings in a sparse setting",0,0,0,0
"2011","Cheshire West and Chester","E06000050","Total",329608,326236,3372,2
"2011","Cheshire West and Chester","E06000050","Urban (total)",243307,240912,2395,2
"2011","Cheshire West and Chester","E06000050","Urban major conurbation",0,0,0,0
"2011","Cheshire West and Chester","E06000050","Urban minor conurbation",0,0,0,0
"2011","Cheshire West and Chester","E06000050","Urban city and town",243307,240912,2395,2
"2011","Cheshire West and Chester","E06000050","Urban city and town in a sparse setting",0,0,0,0
"2011","Cheshire West and Chester","E06000050","Rural (total)",86301,85324,977,0
"2011","Cheshire West and Chester","E06000050","Rural town and fringe",45067,44653,414,0
"2011","Cheshire West and Chester","E06000050","Rural town and fringe in a sparse setting",0,0,0,0
"2011","Cheshire West and Chester","E06000050","Rural village",20335,20018,317,0
"2011","Cheshire West and Chester","E06000050","Rural village in a sparse setting",0,0,0,0
"2011","Cheshire West and Chester","E06000050","Rural hamlet and isolated dwellings",20899,20653,246,0
"2011","Cheshire West and Chester","E06000050","Rural hamlet and isolated dwellings in a sparse setting",0,0,0,0
"2011","Halton","E06000006","Total",125746,124874,872,0
"2011","Halton","E06000006","Urban (total)",122598,121726,872,0
"2011","Halton","E06000006","Urban major conurbation",0,0,0,0
"2011","Halton","E06000006","Urban minor conurbation",0,0,0,0
"2011","Halton","E06000006","Urban city and town",122598,121726,872,0
"2011","Halton","E06000006","Urban city and town in a sparse setting",0,0,0,0
"2011","Halton","E06000006","Rural (total)",3148,3148,0,0
"2011","Halton","E06000006","Rural town and fringe",2188,2188,0,0
"2011","Halton","E06000006","Rural town and fringe in a sparse setting",0,0,0,0
"2011","Halton","E06000006","Rural village",714,714,0,0
"2011","Halton","E06000006","Rural village in a sparse setting",0,0,0,0
"2011","Halton","E06000006","Rural hamlet and isolated dwellings",246,246,0,0
"2011","Halton","E06000006","Rural hamlet and isolated dwellings in a sparse setting",0,0,0,0
"2011","Warrington","E06000007","Total",202228,198828,3400,0
"2011","Warrington","E06000007","Urban (total)",177064,175392,1672,0
"2011","Warrington","E06000007","Urban major conurbation",0,0,0,0
"2011","Warrington","E06000007","Urban minor conurbation",0,0,0,0
"2011","Warrington","E06000007","Urban city and town",177064,175392,1672,0
"2011","Warrington","E06000007","Urban city and town in a sparse setting",0,0,0,0
"2011","Warrington","E06000007","Rural (total)",25164,23436,1728,0
"2011","Warrington","E06000007","Rural town and fringe",15229,14044,1185,0
"2011","Warrington","E06000007","Rural town and fringe in a sparse setting",0,0,0,0
"2011","Warrington","E06000007","Rural village",5637,5213,424,0
"2011","Warrington","E06000007","Rural village in a sparse setting",0,0,0,0
"2011","Warrington","E06000007","Rural hamlet and isolated dwellings",4298,4179,119,0
"2011","Warrington","E06000007","Rural hamlet and isolated dwellings in a sparse setting",0,0,0,0
"2011","Cumbria","E10000006","Total",499858,490939,8919,5
"2011","Cumbria","E10000006","Urban (total)",232039,229124,2915,0
"2011","Cumbria","E10000006","Urban major conurbation",0,0,0,0
"2011","Cumbria","E10000006","Urban minor conurbation",0,0,0,0
"2011","Cumbria","E10000006","Urban city and town",217427,214771,2656,0
"2011","Cumbria","E10000006","Urban city and town in a sparse setting",14612,14353,259,0
"2011","Cumbria","E10000006","Rural (total)",267819,261815,6004,5
"2011","Cumbria","E10000006","Rural town and fringe",102684,101508,1176,0
"2011","Cumbria","E10000006","Rural town and fringe in a sparse setting",28517,27511,1006,3
"2011","Cumbria","E10000006","Rural village",48425,47297,1128,0
"2011","Cumbria","E10000006","Rural village in a sparse setting",37116,36081,1035,1
"2011","Cumbria","E10000006","Rural hamlet and isolated dwellings",26843,26425,418,0
"2011","Cumbria","E10000006","Rural hamlet and isolated dwellings in a sparse setting",24234,22993,1241,1
"2011","Bolton","E08000001","Total",276786,274855,1931,1
"2011","Bolton","E08000001","Urban (total)",274298,272367,1931,1
"2011","Bolton","E08000001","Urban major conurbation",246862,245178,1684,1
"2011","Bolton","E08000001","Urban minor conurbation",0,0,0,0
"2011","Bolton","E08000001","Urban city and town",27436,27189,247,0
"2011","Bolton","E08000001","Urban city and town in a sparse setting",0,0,0,0
"2011","Bolton","E08000001","Rural (total)",2488,2488,0,0
"2011","Bolton","E08000001","Rural town and fringe",560,560,0,0
"2011","Bolton","E08000001","Rural town and fringe in a sparse setting",0,0,0,0
"2011","Bolton","E08000001","Rural village",474,474,0,0
"2011","Bolton","E08000001","Rural village in a sparse setting",0,0,0,0
"2011","Bolton","E08000001","Rural hamlet and isolated dwellings",1454,1454,0,0
"2011","Bolton","E08000001","Rural hamlet and isolated dwellings in a sparse setting",0,0,0,0
"2011","Bury","E08000002","Total",185060,183025,2035,0
"2011","Bury","E08000002","Urban (total)",179934,178111,1823,0
"2011","Bury","E08000002","Urban major conurbation",179215,177392,1823,0
"2011","Bury","E08000002","Urban minor conurbation",0,0,0,0
"2011","Bury","E08000002","Urban city and town",719,719,0,0
"2011","Bury","E08000002","Urban city and town in a sparse setting",0,0,0,0
"2011","Bury","E08000002","Rural (total)",5126,4914,212,0
"2011","Bury","E08000002","Rural town and fringe",2258,2255,3,0
"2011","Bury","E08000002","Rural town and fringe in a sparse setting",0,0,0,0
"2011","Bury","E08000002","Rural village",2061,1971,90,0
"2011","Bury","E08000002","Rural village in a sparse setting",0,0,0,0
"2011","Bury","E08000002","Rural hamlet and isolated dwellings",807,688,119,0
"2011","Bury","E08000002","Rural hamlet and isolated dwellings in a sparse setting",0,0,0,0
"2011","Manchester","E08000003","Total",503127,481030,22097,1
"2011","Manchester","E08000003","Urban (total)",503024,480927,22097,1
"2011","Manchester","E08000003","Urban major conurbation",503024,480927,22097,1
"2011","Manchester","E08000003","Urban minor conurbation",0,0,0,0
"2011","Manchester","E08000003","Urban city and town",0,0,0,0
"2011","Manchester","E08000003","Urban city and town in a sparse setting",0,0,0,0
"2011","Manchester","E08000003","Rural (total)",103,103,0,0
"2011","Manchester","E08000003","Rural town and fringe",0,0,0,0
"2011","Manchester","E08000003","Rural town and fringe in a sparse setting",0,0,0,0
"2011","Manchester","E08000003","Rural village",0,0,0,0
"2011","Manchester","E08000003","Rural village in a sparse setting",0,0,0,0
"2011","Manchester","E08000003","Rural hamlet and isolated dwellings",103,103,0,0
"2011","Manchester","E08000003","Rural hamlet and isolated dwellings in a sparse setting",0,0,0,0
"2011","Oldham","E08000004","Total",224897,223170,1727,0
"2011","Oldham","E08000004","Urban (total)",222240,220552,1688,0
"2011","Oldham","E08000004","Urban major conurbation",214910,213250,1660,0
"2011","Oldham","E08000004","Urban minor conurbation",0,0,0,0
"2011","Oldham","E08000004","Urban city and town",7330,7302,28,0
"2011","Oldham","E08000004","Urban city and town in a sparse setting",0,0,0,0
"2011","Oldham","E08000004","Rural (total)",2657,2618,39,0
"2011","Oldham","E08000004","Rural town and fringe",355,316,39,0
"2011","Oldham","E08000004","Rural town and fringe in a sparse setting",0,0,0,0
"2011","Oldham","E08000004","Rural village",305,305,0,0
"2011","Oldham","E08000004","Rural village in a sparse setting",0,0,0,0
"2011","Oldham","E08000004","Rural hamlet and isolated dwellings",1997,1997,0,0
"2011","Oldham","E08000004","Rural hamlet and isolated dwellings in a sparse setting",0,0,0,0
"2011","Rochdale","E08000005","Total",211699,209552,2147,3
"2011","Rochdale","E08000005","Urban (total)",209122,207042,2080,3
"2011","Rochdale","E08000005","Urban major conurbation",205920,203859,2061,3
"2011","Rochdale","E08000005","Urban minor conurbation",0,0,0,0
"2011","Rochdale","E08000005","Urban city and town",3202,3183,19,0
"2011","Rochdale","E08000005","Urban city and town in a sparse setting",0,0,0,0
"2011","Rochdale","E08000005","Rural (total)",2577,2510,67,0
"2011","Rochdale","E08000005","Rural town and fringe",541,480,61,0
"2011","Rochdale","E08000005","Rural town and fringe in a sparse setting",0,0,0,0
"2011","Rochdale","E08000005","Rural village",523,522,1,0
"2011","Rochdale","E08000005","Rural village in a sparse setting",0,0,0,0
"2011","Rochdale","E08000005","Rural hamlet and isolated dwellings",1513,1508,5,0
"2011","Rochdale","E08000005","Rural hamlet and isolated dwellings in a sparse setting",0,0,0,0
"2011","Salford","E08000006","Total",233933,228346,5587,0
"2011","Salford","E08000006","Urban (total)",233649,228062,5587,0
"2011","Salford","E08000006","Urban major conurbation",233649,228062,5587,0
"2011","Salford","E08000006","Urban minor conurbation",0,0,0,0
"2011","Salford","E08000006","Urban city and town",0,0,0,0
"2011","Salford","E08000006","Urban city and town in a sparse setting",0,0,0,0
"2011","Salford","E08000006","Rural (total)",284,284,0,0
"2011","Salford","E08000006","Rural town and fringe",0,0,0,0
"2011","Salford","E08000006","Rural town and fringe in a sparse setting",0,0,0,0
"2011","Salford","E08000006","Rural village",0,0,0,0
"2011","Salford","E08000006","Rural village in a sparse setting",0,0,0,0
"2011","Salford","E08000006","Rural hamlet and isolated dwellings",284,284,0,0
"2011","Salford","E08000006","Rural hamlet and isolated dwellings in a sparse setting",0,0,0,0
"2011","Stockport","E08000007","Total",283275,280915,2360,0
"2011","Stockport","E08000007","Urban (total)",282026,279682,2344,0
"2011","Stockport","E08000007","Urban major conurbation",274713,272413,2300,0
"2011","Stockport","E08000007","Urban minor conurbation",0,0,0,0
"2011","Stockport","E08000007","Urban city and town",7313,7269,44,0
"2011","Stockport","E08000007","Urban city and town in a sparse setting",0,0,0,0
"2011","Stockport","E08000007","Rural (total)",1249,1233,16,0
"2011","Stockport","E08000007","Rural town and fringe",0,0,0,0
"2011","Stockport","E08000007","Rural town and fringe in a sparse setting",0,0,0,0
"2011","Stockport","E08000007","Rural village",0,0,0,0
"2011","Stockport","E08000007","Rural village in a sparse setting",0,0,0,0
"2011","Stockport","E08000007","Rural hamlet and isolated dwellings",1249,1233,16,0
"2011","Stockport","E08000007","Rural hamlet and isolated dwellings in a sparse setting",0,0,0,0
"2011","Tameside","E08000008","Total",219324,217736,1588,1
"2011","Tameside","E08000008","Urban (total)",218679,217091,1588,1
"2011","Tameside","E08000008","Urban major conurbation",216647,215059,1588,1
"2011","Tameside","E08000008","Urban minor conurbation",0,0,0,0
"2011","Tameside","E08000008","Urban city and town",2032,2032,0,0
"2011","Tameside","E08000008","Urban city and town in a sparse setting",0,0,0,0
"2011","Tameside","E08000008","Rural (total)",645,645,0,0
"2011","Tameside","E08000008","Rural town and fringe",0,0,0,0
"2011","Tameside","E08000008","Rural town and fringe in a sparse setting",0,0,0,0
"2011","Tameside","E08000008","Rural village",0,0,0,0
"2011","Tameside","E08000008","Rural village in a sparse setting",0,0,0,0
"2011","Tameside","E08000008","Rural hamlet and isolated dwellings",645,645,0,0
"2011","Tameside","E08000008","Rural hamlet and isolated dwellings in a sparse setting",0,0,0,0
"2011","Trafford","E08000009","Total",226578,225277,1301,0
"2011","Trafford","E08000009","Urban (total)",225754,224453,1301,0
"2011","Trafford","E08000009","Urban major conurbation",221223,219922,1301,0
"2011","Trafford","E08000009","Urban minor conurbation",0,0,0,0
"2011","Trafford","E08000009","Urban city and town",4531,4531,0,0
"2011","Trafford","E08000009","Urban city and town in a sparse setting",0,0,0,0
"2011","Trafford","E08000009","Rural (total)",824,824,0,0
"2011","Trafford","E08000009","Rural town and fringe",0,0,0,0
"2011","Trafford","E08000009","Rural town and fringe in a sparse setting",0,0,0,0
"2011","Trafford","E08000009","Rural village",585,585,0,0
"2011","Trafford","E08000009","Rural village in a sparse setting",0,0,0,0
"2011","Trafford","E08000009","Rural hamlet and isolated dwellings",239,239,0,0
"2011","Trafford","E08000009","Rural hamlet and isolated dwellings in a sparse setting",0,0,0,0
"2011","Wigan","E08000010","Total",317849,315794,2055,1
"2011","Wigan","E08000010","Urban (total)",306293,304450,1843,1
"2011","Wigan","E08000010","Urban major conurbation",300645,298848,1797,1
"2011","Wigan","E08000010","Urban minor conurbation",0,0,0,0
"2011","Wigan","E08000010","Urban city and town",5648,5602,46,0
"2011","Wigan","E08000010","Urban city and town in a sparse setting",0,0,0,0
"2011","Wigan","E08000010","Rural (total)",11556,11344,212,0
"2011","Wigan","E08000010","Rural town and fringe",7928,7928,0,0
"2011","Wigan","E08000010","Rural town and fringe in a sparse setting",0,0,0,0
"2011","Wigan","E08000010","Rural village",2331,2119,212,0
"2011","Wigan","E08000010","Rural village in a sparse setting",0,0,0,0
"2011","Wigan","E08000010","Rural hamlet and isolated dwellings",1297,1297,0,0
"2011","Wigan","E08000010","Rural hamlet and isolated dwellings in a sparse setting",0,0,0,0
"2011","Lancashire","E10000017","Total",1171339,1143277,28062,7
"2011","Lancashire","E10000017","Urban (total)",929629,912912,16717,7
"2011","Lancashire","E10000017","Urban major conurbation",41647,41344,303,1
"2011","Lancashire","E10000017","Urban minor conurbation",0,0,0,0
"2011","Lancashire","E10000017","Urban city and town",887982,871568,16414,6
"2011","Lancashire","E10000017","Urban city and town in a sparse setting",0,0,0,0
"2011","Lancashire","E10000017","Rural (total)",241710,230365,11345,0
"2011","Lancashire","E10000017","Rural town and fringe",130300,127548,2752,0
"2011","Lancashire","E10000017","Rural town and fringe in a sparse setting",0,0,0,0
"2011","Lancashire","E10000017","Rural village",55508,52917,2591,0
"2011","Lancashire","E10000017","Rural village in a sparse setting",0,0,0,0
"2011","Lancashire","E10000017","Rural hamlet and isolated dwellings",55460,49460,6000,0
"2011","Lancashire","E10000017","Rural hamlet and isolated dwellings in a sparse setting",442,440,2,0
"2011","Knowsley","E08000011","Total",145893,144990,903,0
"2011","Knowsley","E08000011","Urban (total)",144900,143997,903,0
"2011","Knowsley","E08000011","Urban major conurbation",140576,139673,903,0
"2011","Knowsley","E08000011","Urban minor conurbation",0,0,0,0
"2011","Knowsley","E08000011","Urban city and town",4324,4324,0,0
"2011","Knowsley","E08000011","Urban city and town in a sparse setting",0,0,0,0
"2011","Knowsley","E08000011","Rural (total)",993,993,0,0
"2011","Knowsley","E08000011","Rural town and fringe",299,299,0,0
"2011","Knowsley","E08000011","Rural town and fringe in a sparse setting",0,0,0,0
"2011","Knowsley","E08000011","Rural village",0,0,0,0
"2011","Knowsley","E08000011","Rural village in a sparse setting",0,0,0,0
"2011","Knowsley","E08000011","Rural hamlet and isolated dwellings",694,694,0,0
"2011","Knowsley","E08000011","Rural hamlet and isolated dwellings in a sparse setting",0,0,0,0
"2011","Liverpool","E08000012","Total",466415,450085,16330,2
"2011","Liverpool","E08000012","Urban (total)",466415,450085,16330,2
"2011","Liverpool","E08000012","Urban major conurbation",466415,450085,16330,2
"2011","Liverpool","E08000012","Urban minor conurbation",0,0,0,0
"2011","Liverpool","E08000012","Urban city and town",0,0,0,0
"2011","Liverpool","E08000012","Urban city and town in a sparse setting",0,0,0,0
"2011","Liverpool","E08000012","Rural (total)",0,0,0,0
"2011","Liverpool","E08000012","Rural town and fringe",0,0,0,0
"2011","Liverpool","E08000012","Rural town and fringe in a sparse setting",0,0,0,0
"2011","Liverpool","E08000012","Rural village",0,0,0,0
"2011","Liverpool","E08000012","Rural village in a sparse setting",0,0,0,0
"2011","Liverpool","E08000012","Rural hamlet and isolated dwellings",0,0,0,0
"2011","Liverpool","E08000012","Rural hamlet and isolated dwellings in a sparse setting",0,0,0,0
"2011","Sefton","E08000014","Total",273790,269697,4093,1
"2011","Sefton","E08000014","Urban (total)",269811,265751,4060,1
"2011","Sefton","E08000014","Urban major conurbation",154733,153298,1435,0
"2011","Sefton","E08000014","Urban minor conurbation",0,0,0,0
"2011","Sefton","E08000014","Urban city and town",115078,112453,2625,1
"2011","Sefton","E08000014","Urban city and town in a sparse setting",0,0,0,0
"2011","Sefton","E08000014","Rural (total)",3979,3946,33,0
"2011","Sefton","E08000014","Rural town and fringe",2063,2063,0,0
"2011","Sefton","E08000014","Rural town and fringe in a sparse setting",0,0,0,0
"2011","Sefton","E08000014","Rural village",1107,1074,33,0
"2011","Sefton","E08000014","Rural village in a sparse setting",0,0,0,0
"2011","Sefton","E08000014","Rural hamlet and isolated dwellings",809,809,0,0
"2011","Sefton","E08000014","Rural hamlet and isolated dwellings in a sparse setting",0,0,0,0
"2011","St. Helens","E08000013","Total",175308,173958,1350,1
"2011","St. Helens","E08000013","Urban (total)",165579,164370,1209,1
"2011","St. Helens","E08000013","Urban major conurbation",158483,157331,1152,1
"2011","St. Helens","E08000013","Urban minor conurbation",0,0,0,0
"2011","St. Helens","E08000013","Urban city and town",7096,7039,57,0
"2011","St. Helens","E08000013","Urban city and town in a sparse setting",0,0,0,0
"2011","St. Helens","E08000013","Rural (total)",9729,9588,141,0
"2011","St. Helens","E08000013","Rural town and fringe",8131,7992,139,0
"2011","St. Helens","E08000013","Rural town and fringe in a sparse setting",0,0,0,0
"2011","St. Helens","E08000013","Rural village",345,343,2,0
"2011","St. Helens","E08000013","Rural village in a sparse setting",0,0,0,0
"2011","St. Helens","E08000013","Rural hamlet and isolated dwellings",1253,1253,0,0
"2011","St. Helens","E08000013","Rural hamlet and isolated dwellings in a sparse setting",0,0,0,0
"2011","Wirral","E08000015","Total",319783,316384,3399,0
"2011","Wirral","E08000015","Urban (total)",316245,312940,3305,0
"2011","Wirral","E08000015","Urban major conurbation",313774,310482,3292,0
"2011","Wirral","E08000015","Urban minor conurbation",0,0,0,0
"2011","Wirral","E08000015","Urban city and town",2471,2458,13,0
"2011","Wirral","E08000015","Urban city and town in a sparse setting",0,0,0,0
"2011","Wirral","E08000015","Rural (total)",3538,3444,94,0
"2011","Wirral","E08000015","Rural town and fringe",724,724,0,0
"2011","Wirral","E08000015","Rural town and fringe in a sparse setting",0,0,0,0
"2011","Wirral","E08000015","Rural village",1110,1032,78,0
"2011","Wirral","E08000015","Rural village in a sparse setting",0,0,0,0
"2011","Wirral","E08000015","Rural hamlet and isolated dwellings",1704,1688,16,0
"2011","Wirral","E08000015","Rural hamlet and isolated dwellings in a sparse setting",0,0,0,0
"2011","East Riding of Yorkshire","E06000011","Total",334179,326951,7228,0
"2011","East Riding of Yorkshire","E06000011","Urban (total)",187505,183405,4100,0
"2011","East Riding of Yorkshire","E06000011","Urban major conurbation",0,0,0,0
"2011","East Riding of Yorkshire","E06000011","Urban minor conurbation",0,0,0,0
"2011","East Riding of Yorkshire","E06000011","Urban city and town",187505,183405,4100,0
"2011","East Riding of Yorkshire","E06000011","Urban city and town in a sparse setting",0,0,0,0
"2011","East Riding of Yorkshire","E06000011","Rural (total)",146674,143546,3128,0
"2011","East Riding of Yorkshire","E06000011","Rural town and fringe",81176,80242,934,0
"2011","East Riding of Yorkshire","E06000011","Rural town and fringe in a sparse setting",0,0,0,0
"2011","East Riding of Yorkshire","E06000011","Rural village",50108,48809,1299,0
"2011","East Riding of Yorkshire","E06000011","Rural village in a sparse setting",0,0,0,0
"2011","East Riding of Yorkshire","E06000011","Rural hamlet and isolated dwellings",15390,14495,895,0
"2011","East Riding of Yorkshire","E06000011","Rural hamlet and isolated dwellings in a sparse setting",0,0,0,0
"2011","Kingston upon Hull, City of","E06000010","Total",256406,252748,3658,1
"2011","Kingston upon Hull, City of","E06000010","Urban (total)",256406,252748,3658,1
"2011","Kingston upon Hull, City of","E06000010","Urban major conurbation",0,0,0,0
"2011","Kingston upon Hull, City of","E06000010","Urban minor conurbation",0,0,0,0
"2011","Kingston upon Hull, City of","E06000010","Urban city and town",256406,252748,3658,1
"2011","Kingston upon Hull, City of","E06000010","Urban city and town in a sparse setting",0,0,0,0
"2011","Kingston upon Hull, City of","E06000010","Rural (total)",0,0,0,0
"2011","Kingston upon Hull, City of","E06000010","Rural town and fringe",0,0,0,0
"2011","Kingston upon Hull, City of","E06000010","Rural town and fringe in a sparse setting",0,0,0,0
"2011","Kingston upon Hull, City of","E06000010","Rural village",0,0,0,0
"2011","Kingston upon Hull, City of","E06000010","Rural village in a sparse setting",0,0,0,0
"2011","Kingston upon Hull, City of","E06000010","Rural hamlet and isolated dwellings",0,0,0,0
"2011","Kingston upon Hull, City of","E06000010","Rural hamlet and isolated dwellings in a sparse setting",0,0,0,0
"2011","North East Lincolnshire","E06000012","Total",159616,157786,1830,0
"2011","North East Lincolnshire","E06000012","Urban (total)",143802,142245,1557,0
"2011","North East Lincolnshire","E06000012","Urban major conurbation",0,0,0,0
"2011","North East Lincolnshire","E06000012","Urban minor conurbation",0,0,0,0
"2011","North East Lincolnshire","E06000012","Urban city and town",143802,142245,1557,0
"2011","North East Lincolnshire","E06000012","Urban city and town in a sparse setting",0,0,0,0
"2011","North East Lincolnshire","E06000012","Rural (total)",15814,15541,273,0
"2011","North East Lincolnshire","E06000012","Rural town and fringe",11171,11087,84,0
"2011","North East Lincolnshire","E06000012","Rural town and fringe in a sparse setting",0,0,0,0
"2011","North East Lincolnshire","E06000012","Rural village",2975,2935,40,0
"2011","North East Lincolnshire","E06000012","Rural village in a sparse setting",0,0,0,0
"2011","North East Lincolnshire","E06000012","Rural hamlet and isolated dwellings",1668,1519,149,0
"2011","North East Lincolnshire","E06000012","Rural hamlet and isolated dwellings in a sparse setting",0,0,0,0
"2011","North Lincolnshire","E06000013","Total",167446,165871,1575,1
"2011","North Lincolnshire","E06000013","Urban (total)",92151,91375,776,1
"2011","North Lincolnshire","E06000013","Urban major conurbation",0,0,0,0
"2011","North Lincolnshire","E06000013","Urban minor conurbation",0,0,0,0
"2011","North Lincolnshire","E06000013","Urban city and town",92151,91375,776,1
"2011","North Lincolnshire","E06000013","Urban city and town in a sparse setting",0,0,0,0
"2011","North Lincolnshire","E06000013","Rural (total)",75295,74496,799,0
"2011","North Lincolnshire","E06000013","Rural town and fringe",48350,48011,339,0
"2011","North Lincolnshire","E06000013","Rural town and fringe in a sparse setting",0,0,0,0
"2011","North Lincolnshire","E06000013","Rural village",19672,19385,287,0
"2011","North Lincolnshire","E06000013","Rural village in a sparse setting",0,0,0,0
"2011","North Lincolnshire","E06000013","Rural hamlet and isolated dwellings",7273,7100,173,0
"2011","North Lincolnshire","E06000013","Rural hamlet and isolated dwellings in a sparse setting",0,0,0,0
"2011","York","E06000014","Total",198051,190392,7659,2
"2011","York","E06000014","Urban (total)",165611,159124,6487,2
"2011","York","E06000014","Urban major conurbation",0,0,0,0
"2011","York","E06000014","Urban minor conurbation",0,0,0,0
"2011","York","E06000014","Urban city and town",165611,159124,6487,2
"2011","York","E06000014","Urban city and town in a sparse setting",0,0,0,0
"2011","York","E06000014","Rural (total)",32440,31268,1172,0
"2011","York","E06000014","Rural town and fringe",23880,23132,748,0
"2011","York","E06000014","Rural town and fringe in a sparse setting",0,0,0,0
"2011","York","E06000014","Rural village",6159,5806,353,0
"2011","York","E06000014","Rural village in a sparse setting",0,0,0,0
"2011","York","E06000014","Rural hamlet and isolated dwellings",2401,2330,71,0
"2011","York","E06000014","Rural hamlet and isolated dwellings in a sparse setting",0,0,0,0
"2011","North Yorkshire","E10000023","Total",598376,582624,15752,6
"2011","North Yorkshire","E10000023","Urban (total)",270559,261405,9154,2
"2011","North Yorkshire","E10000023","Urban major conurbation",338,338,0,0
"2011","North Yorkshire","E10000023","Urban minor conurbation",0,0,0,0
"2011","North Yorkshire","E10000023","Urban city and town",257008,248192,8816,2
"2011","North Yorkshire","E10000023","Urban city and town in a sparse setting",13213,12875,338,0
"2011","North Yorkshire","E10000023","Rural (total)",327817,321219,6598,4
"2011","North Yorkshire","E10000023","Rural town and fringe",100167,98306,1861,0
"2011","North Yorkshire","E10000023","Rural town and fringe in a sparse setting",32311,31783,528,0
"2011","North Yorkshire","E10000023","Rural village",101997,99843,2154,0
"2011","North Yorkshire","E10000023","Rural village in a sparse setting",23101,22791,310,2
"2011","North Yorkshire","E10000023","Rural hamlet and isolated dwellings",55466,53864,1602,2
"2011","North Yorkshire","E10000023","Rural hamlet and isolated dwellings in a sparse setting",14775,14632,143,0
"2011","Barnsley","E08000016","Total",231221,229539,1682,0
"2011","Barnsley","E08000016","Urban (total)",207048,205566,1482,0
"2011","Barnsley","E08000016","Urban major conurbation",0,0,0,0
"2011","Barnsley","E08000016","Urban minor conurbation",184804,183356,1448,0
"2011","Barnsley","E08000016","Urban city and town",22244,22210,34,0
"2011","Barnsley","E08000016","Urban city and town in a sparse setting",0,0,0,0
"2011","Barnsley","E08000016","Rural (total)",24173,23973,200,0
"2011","Barnsley","E08000016","Rural town and fringe",14567,14401,166,0
"2011","Barnsley","E08000016","Rural town and fringe in a sparse setting",0,0,0,0
"2011","Barnsley","E08000016","Rural village",5874,5864,10,0
"2011","Barnsley","E08000016","Rural village in a sparse setting",0,0,0,0
"2011","Barnsley","E08000016","Rural hamlet and isolated dwellings",3732,3708,24,0
"2011","Barnsley","E08000016","Rural hamlet and isolated dwellings in a sparse setting",0,0,0,0
"2011","Doncaster","E08000017","Total",302402,297200,5202,1
"2011","Doncaster","E08000017","Urban (total)",260240,257335,2905,1
"2011","Doncaster","E08000017","Urban major conurbation",0,0,0,0
"2011","Doncaster","E08000017","Urban minor conurbation",215009,212484,2525,1
"2011","Doncaster","E08000017","Urban city and town",45231,44851,380,0
"2011","Doncaster","E08000017","Urban city and town in a sparse setting",0,0,0,0
"2011","Doncaster","E08000017","Rural (total)",42162,39865,2297,0
"2011","Doncaster","E08000017","Rural town and fringe",27064,26953,111,0
"2011","Doncaster","E08000017","Rural town and fringe in a sparse setting",0,0,0,0
"2011","Doncaster","E08000017","Rural village",10257,8391,1866,0
"2011","Doncaster","E08000017","Rural village in a sparse setting",0,0,0,0
"2011","Doncaster","E08000017","Rural hamlet and isolated dwellings",4841,4521,320,0
"2011","Doncaster","E08000017","Rural hamlet and isolated dwellings in a sparse setting",0,0,0,0
"2011","Rotherham","E08000018","Total",257280,255334,1946,5
"2011","Rotherham","E08000018","Urban (total)",231177,229373,1804,5
"2011","Rotherham","E08000018","Urban major conurbation",0,0,0,0
"2011","Rotherham","E08000018","Urban minor conurbation",185796,184282,1514,5
"2011","Rotherham","E08000018","Urban city and town",45381,45091,290,0
"2011","Rotherham","E08000018","Urban city and town in a sparse setting",0,0,0,0
"2011","Rotherham","E08000018","Rural (total)",26103,25961,142,0
"2011","Rotherham","E08000018","Rural town and fringe",20435,20349,86,0
"2011","Rotherham","E08000018","Rural town and fringe in a sparse setting",0,0,0,0
"2011","Rotherham","E08000018","Rural village",3893,3839,54,0
"2011","Rotherham","E08000018","Rural village in a sparse setting",0,0,0,0
"2011","Rotherham","E08000018","Rural hamlet and isolated dwellings",1775,1773,2,0
"2011","Rotherham","E08000018","Rural hamlet and isolated dwellings in a sparse setting",0,0,0,0
"2011","Sheffield","E08000019","Total",552698,539064,13634,2
"2011","Sheffield","E08000019","Urban (total)",543008,529439,13569,2
"2011","Sheffield","E08000019","Urban major conurbation",0,0,0,0
"2011","Sheffield","E08000019","Urban minor conurbation",525842,512500,13342,1
"2011","Sheffield","E08000019","Urban city and town",17166,16939,227,1
"2011","Sheffield","E08000019","Urban city and town in a sparse setting",0,0,0,0
"2011","Sheffield","E08000019","Rural (total)",9690,9625,65,0
"2011","Sheffield","E08000019","Rural town and fringe",6060,6040,20,0
"2011","Sheffield","E08000019","Rural town and fringe in a sparse setting",0,0,0,0
"2011","Sheffield","E08000019","Rural village",1630,1630,0,0
"2011","Sheffield","E08000019","Rural village in a sparse setting",0,0,0,0
"2011","Sheffield","E08000019","Rural hamlet and isolated dwellings",2000,1955,45,0
"2011","Sheffield","E08000019","Rural hamlet and isolated dwellings in a sparse setting",0,0,0,0
"2011","Bradford","E08000032","Total",522452,515315,7137,0
"2011","Bradford","E08000032","Urban (total)",486624,480220,6404,0
"2011","Bradford","E08000032","Urban major conurbation",398239,392854,5385,0
"2011","Bradford","E08000032","Urban minor conurbation",0,0,0,0
"2011","Bradford","E08000032","Urban city and town",88385,87366,1019,0
"2011","Bradford","E08000032","Urban city and town in a sparse setting",0,0,0,0
"2011","Bradford","E08000032","Rural (total)",35828,35095,733,0
"2011","Bradford","E08000032","Rural town and fringe",26924,26279,645,0
"2011","Bradford","E08000032","Rural town and fringe in a sparse setting",0,0,0,0
"2011","Bradford","E08000032","Rural village",1131,1131,0,0
"2011","Bradford","E08000032","Rural village in a sparse setting",0,0,0,0
"2011","Bradford","E08000032","Rural hamlet and isolated dwellings",7773,7685,88,0
"2011","Bradford","E08000032","Rural hamlet and isolated dwellings in a sparse setting",0,0,0,0
"2011","Calderdale","E08000033","Total",203826,202376,1450,1
"2011","Calderdale","E08000033","Urban (total)",164600,163280,1320,1
"2011","Calderdale","E08000033","Urban major conurbation",148908,147784,1124,1
"2011","Calderdale","E08000033","Urban minor conurbation",0,0,0,0
"2011","Calderdale","E08000033","Urban city and town",15692,15496,196,0
"2011","Calderdale","E08000033","Urban city and town in a sparse setting",0,0,0,0
"2011","Calderdale","E08000033","Rural (total)",39226,39096,130,0
"2011","Calderdale","E08000033","Rural town and fringe",20266,20166,100,0
"2011","Calderdale","E08000033","Rural town and fringe in a sparse setting",0,0,0,0
"2011","Calderdale","E08000033","Rural village",7292,7280,12,0
"2011","Calderdale","E08000033","Rural village in a sparse setting",0,0,0,0
"2011","Calderdale","E08000033","Rural hamlet and isolated dwellings",11668,11650,18,0
"2011","Calderdale","E08000033","Rural hamlet and isolated dwellings in a sparse setting",0,0,0,0
"2011","Kirklees","E08000034","Total",422458,416840,5618,1
"2011","Kirklees","E08000034","Urban (total)",373540,369389,4151,1
"2011","Kirklees","E08000034","Urban major conurbation",351616,347604,4012,1
"2011","Kirklees","E08000034","Urban minor conurbation",0,0,0,0
"2011","Kirklees","E08000034","Urban city and town",21924,21785,139,0
"2011","Kirklees","E08000034","Urban city and town in a sparse setting",0,0,0,0
"2011","Kirklees","E08000034","Rural (total)",48918,47451,1467,0
"2011","Kirklees","E08000034","Rural town and fringe",33271,33075,196,0
"2011","Kirklees","E08000034","Rural town and fringe in a sparse setting",0,0,0,0
"2011","Kirklees","E08000034","Rural village",8983,7822,1161,0
"2011","Kirklees","E08000034","Rural village in a sparse setting",0,0,0,0
"2011","Kirklees","E08000034","Rural hamlet and isolated dwellings",6664,6554,110,0
"2011","Kirklees","E08000034","Rural hamlet and isolated dwellings in a sparse setting",0,0,0,0
"2011","Leeds","E08000035","Total",751485,731373,20112,1
"2011","Leeds","E08000035","Urban (total)",708450,689296,19154,1
"2011","Leeds","E08000035","Urban major conurbation",656134,637599,18535,1
"2011","Leeds","E08000035","Urban minor conurbation",0,0,0,0
"2011","Leeds","E08000035","Urban city and town",52316,51697,619,0
"2011","Leeds","E08000035","Urban city and town in a sparse setting",0,0,0,0
"2011","Leeds","E08000035","Rural (total)",43035,42077,958,0
"2011","Leeds","E08000035","Rural town and fringe",30197,30056,141,0
"2011","Leeds","E08000035","Rural town and fringe in a sparse setting",0,0,0,0
"2011","Leeds","E08000035","Rural village",9115,8301,814,0
"2011","Leeds","E08000035","Rural village in a sparse setting",0,0,0,0
"2011","Leeds","E08000035","Rural hamlet and isolated dwellings",3723,3720,3,0
"2011","Leeds","E08000035","Rural hamlet and isolated dwellings in a sparse setting",0,0,0,0
"2011","Wakefield","E08000036","Total",325837,322264,3573,3
"2011","Wakefield","E08000036","Urban (total)",268009,265139,2870,3
"2011","Wakefield","E08000036","Urban major conurbation",129269,127452,1817,3
"2011","Wakefield","E08000036","Urban minor conurbation",0,0,0,0
"2011","Wakefield","E08000036","Urban city and town",138740,137687,1053,0
"2011","Wakefield","E08000036","Urban city and town in a sparse setting",0,0,0,0
"2011","Wakefield","E08000036","Rural (total)",57828,57125,703,0
"2011","Wakefield","E08000036","Rural town and fringe",44793,44455,338,0
"2011","Wakefield","E08000036","Rural town and fringe in a sparse setting",0,0,0,0
"2011","Wakefield","E08000036","Rural village",10504,10475,29,0
"2011","Wakefield","E08000036","Rural village in a sparse setting",0,0,0,0
"2011","Wakefield","E08000036","Rural hamlet and isolated dwellings",2531,2195,336,0
"2011","Wakefield","E08000036","Rural hamlet and isolated dwellings in a sparse setting",0,0,0,0
"2011","Derby","E06000015","Total",248752,244625,4127,1
"2011","Derby","E06000015","Urban (total)",248752,244625,4127,1
"2011","Derby","E06000015","Urban major conurbation",0,0,0,0
"2011","Derby","E06000015","Urban minor conurbation",0,0,0,0
"2011","Derby","E06000015","Urban city and town",248752,244625,4127,1
"2011","Derby","E06000015","Urban city and town in a sparse setting",0,0,0,0
"2011","Derby","E06000015","Rural (total)",0,0,0,0
"2011","Derby","E06000015","Rural town and fringe",0,0,0,0
"2011","Derby","E06000015","Rural town and fringe in a sparse setting",0,0,0,0
"2011","Derby","E06000015","Rural village",0,0,0,0
"2011","Derby","E06000015","Rural village in a sparse setting",0,0,0,0
"2011","Derby","E06000015","Rural hamlet and isolated dwellings",0,0,0,0
"2011","Derby","E06000015","Rural hamlet and isolated dwellings in a sparse setting",0,0,0,0
"2011","Leicester","E06000016","Total",329839,321527,8312,1
"2011","Leicester","E06000016","Urban (total)",329283,320971,8312,1
"2011","Leicester","E06000016","Urban major conurbation",0,0,0,0
"2011","Leicester","E06000016","Urban minor conurbation",0,0,0,0
"2011","Leicester","E06000016","Urban city and town",329283,320971,8312,1
"2011","Leicester","E06000016","Urban city and town in a sparse setting",0,0,0,0
"2011","Leicester","E06000016","Rural (total)",556,556,0,0
"2011","Leicester","E06000016","Rural town and fringe",0,0,0,0
"2011","Leicester","E06000016","Rural town and fringe in a sparse setting",0,0,0,0
"2011","Leicester","E06000016","Rural village",0,0,0,0
"2011","Leicester","E06000016","Rural village in a sparse setting",0,0,0,0
"2011","Leicester","E06000016","Rural hamlet and isolated dwellings",556,556,0,0
"2011","Leicester","E06000016","Rural hamlet and isolated dwellings in a sparse setting",0,0,0,0
"2011","Nottingham","E06000018","Total",305680,289738,15942,3
"2011","Nottingham","E06000018","Urban (total)",305680,289738,15942,3
"2011","Nottingham","E06000018","Urban major conurbation",0,0,0,0
"2011","Nottingham","E06000018","Urban minor conurbation",305680,289738,15942,3
"2011","Nottingham","E06000018","Urban city and town",0,0,0,0
"2011","Nottingham","E06000018","Urban city and town in a sparse setting",0,0,0,0
"2011","Nottingham","E06000018","Rural (total)",0,0,0,0
"2011","Nottingham","E06000018","Rural town and fringe",0,0,0,0
"2011","Nottingham","E06000018","Rural town and fringe in a sparse setting",0,0,0,0
"2011","Nottingham","E06000018","Rural village",0,0,0,0
"2011","Nottingham","E06000018","Rural village in a sparse setting",0,0,0,0
"2011","Nottingham","E06000018","Rural hamlet and isolated dwellings",0,0,0,0
"2011","Nottingham","E06000018","Rural hamlet and isolated dwellings in a sparse setting",0,0,0,0
"2011","Rutland","E06000017","Total",37369,34252,3117,0
"2011","Rutland","E06000017","Urban (total)",11522,10979,543,0
"2011","Rutland","E06000017","Urban major conurbation",0,0,0,0
"2011","Rutland","E06000017","Urban minor conurbation",0,0,0,0
"2011","Rutland","E06000017","Urban city and town",11522,10979,543,0
"2011","Rutland","E06000017","Urban city and town in a sparse setting",0,0,0,0
"2011","Rutland","E06000017","Rural (total)",25847,23273,2574,0
"2011","Rutland","E06000017","Rural town and fringe",9181,8154,1027,0
"2011","Rutland","E06000017","Rural town and fringe in a sparse setting",0,0,0,0
"2011","Rutland","E06000017","Rural village",16038,14506,1532,0
"2011","Rutland","E06000017","Rural village in a sparse setting",0,0,0,0
"2011","Rutland","E06000017","Rural hamlet and isolated dwellings",628,613,15,0
"2011","Rutland","E06000017","Rural hamlet and isolated dwellings in a sparse setting",0,0,0,0
"2011","Derbyshire","E10000007","Total",769686,760840,8846,1
"2011","Derbyshire","E10000007","Urban (total)",561502,556145,5357,1
"2011","Derbyshire","E10000007","Urban major conurbation",31080,30848,232,0
"2011","Derbyshire","E10000007","Urban minor conurbation",207595,205784,1811,0
"2011","Derbyshire","E10000007","Urban city and town",322827,319513,3314,1
"2011","Derbyshire","E10000007","Urban city and town in a sparse setting",0,0,0,0
"2011","Derbyshire","E10000007","Rural (total)",208184,204695,3489,0
"2011","Derbyshire","E10000007","Rural town and fringe",112290,110690,1600,0
"2011","Derbyshire","E10000007","Rural town and fringe in a sparse setting",0,0,0,0
"2011","Derbyshire","E10000007","Rural village",64908,63931,977,0
"2011","Derbyshire","E10000007","Rural village in a sparse setting",0,0,0,0
"2011","Derbyshire","E10000007","Rural hamlet and isolated dwellings",30986,30074,912,0
"2011","Derbyshire","E10000007","Rural hamlet and isolated dwellings in a sparse setting",0,0,0,0
"2011","Leicestershire","E10000018","Total",650489,636274,14215,0
"2011","Leicestershire","E10000018","Urban (total)",451913,440191,11722,0
"2011","Leicestershire","E10000018","Urban major conurbation",0,0,0,0
"2011","Leicestershire","E10000018","Urban minor conurbation",0,0,0,0
"2011","Leicestershire","E10000018","Urban city and town",451913,440191,11722,0
"2011","Leicestershire","E10000018","Urban city and town in a sparse setting",0,0,0,0
"2011","Leicestershire","E10000018","Rural (total)",198576,196083,2493,0
"2011","Leicestershire","E10000018","Rural town and fringe",114901,114232,669,0
"2011","Leicestershire","E10000018","Rural town and fringe in a sparse setting",0,0,0,0
"2011","Leicestershire","E10000018","Rural village",69471,68649,822,0
"2011","Leicestershire","E10000018","Rural village in a sparse setting",0,0,0,0
"2011","Leicestershire","E10000018","Rural hamlet and isolated dwellings",14204,13202,1002,0
"2011","Leicestershire","E10000018","Rural hamlet and isolated dwellings in a sparse setting",0,0,0,0
"2011","Lincolnshire","E10000019","Total",713653,698748,14905,5
"2011","Lincolnshire","E10000019","Urban (total)",370388,360413,9975,2
"2011","Lincolnshire","E10000019","Urban major conurbation",0,0,0,0
"2011","Lincolnshire","E10000019","Urban minor conurbation",0,0,0,0
"2011","Lincolnshire","E10000019","Urban city and town",358224,348543,9681,2
"2011","Lincolnshire","E10000019","Urban city and town in a sparse setting",12164,11870,294,0
"2011","Lincolnshire","E10000019","Rural (total)",343265,338335,4930,3
"2011","Lincolnshire","E10000019","Rural town and fringe",146932,145021,1911,2
"2011","Lincolnshire","E10000019","Rural town and fringe in a sparse setting",6504,6389,115,0
"2011","Lincolnshire","E10000019","Rural village",120962,119315,1647,1
"2011","Lincolnshire","E10000019","Rural village in a sparse setting",11359,11246,113,0
"2011","Lincolnshire","E10000019","Rural hamlet and isolated dwellings",49701,48715,986,0
"2011","Lincolnshire","E10000019","Rural hamlet and isolated dwellings in a sparse setting",7807,7649,158,0
"2011","Northamptonshire","E10000021","Total",691952,681850,10102,3
"2011","Northamptonshire","E10000021","Urban (total)",471327,465347,5980,2
"2011","Northamptonshire","E10000021","Urban major conurbation",0,0,0,0
"2011","Northamptonshire","E10000021","Urban minor conurbation",0,0,0,0
"2011","Northamptonshire","E10000021","Urban city and town",471327,465347,5980,2
"2011","Northamptonshire","E10000021","Urban city and town in a sparse setting",0,0,0,0
"2011","Northamptonshire","E10000021","Rural (total)",220625,216503,4122,1
"2011","Northamptonshire","E10000021","Rural town and fringe",134088,132092,1996,0
"2011","Northamptonshire","E10000021","Rural town and fringe in a sparse setting",0,0,0,0
"2011","Northamptonshire","E10000021","Rural village",74005,72082,1923,1
"2011","Northamptonshire","E10000021","Rural village in a sparse setting",0,0,0,0
"2011","Northamptonshire","E10000021","Rural hamlet and isolated dwellings",12532,12329,203,0
"2011","Northamptonshire","E10000021","Rural hamlet and isolated dwellings in a sparse setting",0,0,0,0
"2011","Nottinghamshire","E10000024","Total",785802,774338,11464,3
"2011","Nottinghamshire","E10000024","Urban (total)",572527,567238,5289,3
"2011","Nottinghamshire","E10000024","Urban major conurbation",0,0,0,0
"2011","Nottinghamshire","E10000024","Urban minor conurbation",281375,279106,2269,2
"2011","Nottinghamshire","E10000024","Urban city and town",291152,288132,3020,1
"2011","Nottinghamshire","E10000024","Urban city and town in a sparse setting",0,0,0,0
"2011","Nottinghamshire","E10000024","Rural (total)",213275,207100,6175,0
"2011","Nottinghamshire","E10000024","Rural town and fringe",138128,137025,1103,0
"2011","Nottinghamshire","E10000024","Rural town and fringe in a sparse setting",0,0,0,0
"2011","Nottinghamshire","E10000024","Rural village",57665,54135,3530,0
"2011","Nottinghamshire","E10000024","Rural village in a sparse setting",0,0,0,0
"2011","Nottinghamshire","E10000024","Rural hamlet and isolated dwellings",17482,15940,1542,0
"2011","Nottinghamshire","E10000024","Rural hamlet and isolated dwellings in a sparse setting",0,0,0,0
"2011","Herefordshire, County of","E06000019","Total",183477,180595,2882,1
"2011","Herefordshire, County of","E06000019","Urban (total)",84335,83178,1157,1
"2011","Herefordshire, County of","E06000019","Urban major conurbation",0,0,0,0
"2011","Herefordshire, County of","E06000019","Urban minor conurbation",0,0,0,0
"2011","Herefordshire, County of","E06000019","Urban city and town",82342,81194,1148,1
"2011","Herefordshire, County of","E06000019","Urban city and town in a sparse setting",1993,1984,9,0
"2011","Herefordshire, County of","E06000019","Rural (total)",99142,97417,1725,0
"2011","Herefordshire, County of","E06000019","Rural town and fringe",15437,15074,363,0
"2011","Herefordshire, County of","E06000019","Rural town and fringe in a sparse setting",2427,2370,57,0
"2011","Herefordshire, County of","E06000019","Rural village",32874,32396,478,0
"2011","Herefordshire, County of","E06000019","Rural village in a sparse setting",6681,6557,124,0
"2011","Herefordshire, County of","E06000019","Rural hamlet and isolated dwellings",30764,30144,620,0
"2011","Herefordshire, County of","E06000019","Rural hamlet and isolated dwellings in a sparse setting",10959,10876,83,0
"2011","Shropshire","E06000051","Total",306129,298183,7946,2
"2011","Shropshire","E06000051","Urban (total)",130660,128173,2487,1
"2011","Shropshire","E06000051","Urban major conurbation",0,0,0,0
"2011","Shropshire","E06000051","Urban minor conurbation",0,0,0,0
"2011","Shropshire","E06000051","Urban city and town",120145,117799,2346,1
"2011","Shropshire","E06000051","Urban city and town in a sparse setting",10515,10374,141,0
"2011","Shropshire","E06000051","Rural (total)",175469,170010,5459,1
"2011","Shropshire","E06000051","Rural town and fringe",65308,64393,915,0
"2011","Shropshire","E06000051","Rural town and fringe in a sparse setting",4392,4268,124,0
"2011","Shropshire","E06000051","Rural village",42946,41363,1583,0
"2011","Shropshire","E06000051","Rural village in a sparse setting",4619,4617,2,0
"2011","Shropshire","E06000051","Rural hamlet and isolated dwellings",49423,46784,2639,1
"2011","Shropshire","E06000051","Rural hamlet and isolated dwellings in a sparse setting",8781,8585,196,0
"2011","Stoke-on-Trent","E06000021","Total",249008,246075,2933,2
"2011","Stoke-on-Trent","E06000021","Urban (total)",248337,245450,2887,2
"2011","Stoke-on-Trent","E06000021","Urban major conurbation",0,0,0,0
"2011","Stoke-on-Trent","E06000021","Urban minor conurbation",0,0,0,0
"2011","Stoke-on-Trent","E06000021","Urban city and town",248337,245450,2887,2
"2011","Stoke-on-Trent","E06000021","Urban city and town in a sparse setting",0,0,0,0
"2011","Stoke-on-Trent","E06000021","Rural (total)",671,625,46,0
"2011","Stoke-on-Trent","E06000021","Rural town and fringe",0,0,0,0
"2011","Stoke-on-Trent","E06000021","Rural town and fringe in a sparse setting",0,0,0,0
"2011","Stoke-on-Trent","E06000021","Rural village",483,449,34,0
"2011","Stoke-on-Trent","E06000021","Rural village in a sparse setting",0,0,0,0
"2011","Stoke-on-Trent","E06000021","Rural hamlet and isolated dwellings",188,176,12,0
"2011","Stoke-on-Trent","E06000021","Rural hamlet and isolated dwellings in a sparse setting",0,0,0,0
"2011","Telford and Wrekin","E06000020","Total",166641,164440,2201,0
"2011","Telford and Wrekin","E06000020","Urban (total)",155464,154213,1251,0
"2011","Telford and Wrekin","E06000020","Urban major conurbation",0,0,0,0
"2011","Telford and Wrekin","E06000020","Urban minor conurbation",0,0,0,0
"2011","Telford and Wrekin","E06000020","Urban city and town",155464,154213,1251,0
"2011","Telford and Wrekin","E06000020","Urban city and town in a sparse setting",0,0,0,0
"2011","Telford and Wrekin","E06000020","Rural (total)",11177,10227,950,0
"2011","Telford and Wrekin","E06000020","Rural town and fringe",632,628,4,0
"2011","Telford and Wrekin","E06000020","Rural town and fringe in a sparse setting",0,0,0,0
"2011","Telford and Wrekin","E06000020","Rural village",5793,5767,26,0
"2011","Telford and Wrekin","E06000020","Rural village in a sparse setting",0,0,0,0
"2011","Telford and Wrekin","E06000020","Rural hamlet and isolated dwellings",4752,3832,920,0
"2011","Telford and Wrekin","E06000020","Rural hamlet and isolated dwellings in a sparse setting",0,0,0,0
"2011","Staffordshire","E10000028","Total",848489,832952,15537,6
"2011","Staffordshire","E10000028","Urban (total)",642633,635681,6952,3
"2011","Staffordshire","E10000028","Urban major conurbation",154961,153949,1012,0
"2011","Staffordshire","E10000028","Urban minor conurbation",0,0,0,0
"2011","Staffordshire","E10000028","Urban city and town",487672,481732,5940,3
"2011","Staffordshire","E10000028","Urban city and town in a sparse setting",0,0,0,0
"2011","Staffordshire","E10000028","Rural (total)",205856,197271,8585,3
"2011","Staffordshire","E10000028","Rural town and fringe",94813,94393,420,2
"2011","Staffordshire","E10000028","Rural town and fringe in a sparse setting",0,0,0,0
"2011","Staffordshire","E10000028","Rural village",63277,58170,5107,0
"2011","Staffordshire","E10000028","Rural village in a sparse setting",0,0,0,0
"2011","Staffordshire","E10000028","Rural hamlet and isolated dwellings",47766,44708,3058,1
"2011","Staffordshire","E10000028","Rural hamlet and isolated dwellings in a sparse setting",0,0,0,0
"2011","Warwickshire","E10000031","Total",545474,537501,7973,4
"2011","Warwickshire","E10000031","Urban (total)",365377,359641,5736,3
"2011","Warwickshire","E10000031","Urban major conurbation",0,0,0,0
"2011","Warwickshire","E10000031","Urban minor conurbation",0,0,0,0
"2011","Warwickshire","E10000031","Urban city and town",365377,359641,5736,3
"2011","Warwickshire","E10000031","Urban city and town in a sparse setting",0,0,0,0
"2011","Warwickshire","E10000031","Rural (total)",180097,177860,2237,1
"2011","Warwickshire","E10000031","Rural town and fringe",92589,91778,811,0
"2011","Warwickshire","E10000031","Rural town and fringe in a sparse setting",0,0,0,0
"2011","Warwickshire","E10000031","Rural village",60642,59716,926,1
"2011","Warwickshire","E10000031","Rural village in a sparse setting",0,0,0,0
"2011","Warwickshire","E10000031","Rural hamlet and isolated dwellings",26866,26366,500,0
"2011","Warwickshire","E10000031","Rural hamlet and isolated dwellings in a sparse setting",0,0,0,0
"2011","Birmingham","E08000025","Total",1073045,1051366,21679,1
"2011","Birmingham","E08000025","Urban (total)",1072492,1050813,21679,1
"2011","Birmingham","E08000025","Urban major conurbation",1072492,1050813,21679,1
"2011","Birmingham","E08000025","Urban minor conurbation",0,0,0,0
"2011","Birmingham","E08000025","Urban city and town",0,0,0,0
"2011","Birmingham","E08000025","Urban city and town in a sparse setting",0,0,0,0
"2011","Birmingham","E08000025","Rural (total)",553,553,0,0
"2011","Birmingham","E08000025","Rural town and fringe",0,0,0,0
"2011","Birmingham","E08000025","Rural town and fringe in a sparse setting",0,0,0,0
"2011","Birmingham","E08000025","Rural village",0,0,0,0
"2011","Birmingham","E08000025","Rural village in a sparse setting",0,0,0,0
"2011","Birmingham","E08000025","Rural hamlet and isolated dwellings",553,553,0,0
"2011","Birmingham","E08000025","Rural hamlet and isolated dwellings in a sparse setting",0,0,0,0
"2011","Coventry","E08000026","Total",316960,307730,9230,0
"2011","Coventry","E08000026","Urban (total)",316395,307225,9170,0
"2011","Coventry","E08000026","Urban major conurbation",0,0,0,0
"2011","Coventry","E08000026","Urban minor conurbation",0,0,0,0
"2011","Coventry","E08000026","Urban city and town",316395,307225,9170,0
"2011","Coventry","E08000026","Urban city and town in a sparse setting",0,0,0,0
"2011","Coventry","E08000026","Rural (total)",565,505,60,0
"2011","Coventry","E08000026","Rural town and fringe",0,0,0,0
"2011","Coventry","E08000026","Rural town and fringe in a sparse setting",0,0,0,0
"2011","Coventry","E08000026","Rural village",0,0,0,0
"2011","Coventry","E08000026","Rural village in a sparse setting",0,0,0,0
"2011","Coventry","E08000026","Rural hamlet and isolated dwellings",565,505,60,0
"2011","Coventry","E08000026","Rural hamlet and isolated dwellings in a sparse setting",0,0,0,0
"2011","Dudley","E08000027","Total",312925,310398,2527,0
"2011","Dudley","E08000027","Urban (total)",312649,310122,2527,0
"2011","Dudley","E08000027","Urban major conurbation",312399,309872,2527,0
"2011","Dudley","E08000027","Urban minor conurbation",0,0,0,0
"2011","Dudley","E08000027","Urban city and town",250,250,0,0
"2011","Dudley","E08000027","Urban city and town in a sparse setting",0,0,0,0
"2011","Dudley","E08000027","Rural (total)",276,276,0,0
"2011","Dudley","E08000027","Rural town and fringe",276,276,0,0
"2011","Dudley","E08000027","Rural town and fringe in a sparse setting",0,0,0,0
"2011","Dudley","E08000027","Rural village",0,0,0,0
"2011","Dudley","E08000027","Rural village in a sparse setting",0,0,0,0
"2011","Dudley","E08000027","Rural hamlet and isolated dwellings",0,0,0,0
"2011","Dudley","E08000027","Rural hamlet and isolated dwellings in a sparse setting",0,0,0,0
"2011","Sandwell","E08000028","Total",308063,305928,2135,0
"2011","Sandwell","E08000028","Urban (total)",308063,305928,2135,0
"2011","Sandwell","E08000028","Urban major conurbation",308063,305928,2135,0
"2011","Sandwell","E08000028","Urban minor conurbation",0,0,0,0
"2011","Sandwell","E08000028","Urban city and town",0,0,0,0
"2011","Sandwell","E08000028","Urban city and town in a sparse setting",0,0,0,0
"2011","Sandwell","E08000028","Rural (total)",0,0,0,0
"2011","Sandwell","E08000028","Rural town and fringe",0,0,0,0
"2011","Sandwell","E08000028","Rural town and fringe in a sparse setting",0,0,0,0
"2011","Sandwell","E08000028","Rural village",0,0,0,0
"2011","Sandwell","E08000028","Rural village in a sparse setting",0,0,0,0
"2011","Sandwell","E08000028","Rural hamlet and isolated dwellings",0,0,0,0
"2011","Sandwell","E08000028","Rural hamlet and isolated dwellings in a sparse setting",0,0,0,0
"2011","Solihull","E08000029","Total",206674,205087,1587,1
"2011","Solihull","E08000029","Urban (total)",186276,184762,1514,1
"2011","Solihull","E08000029","Urban major conurbation",182706,181201,1505,1
"2011","Solihull","E08000029","Urban minor conurbation",0,0,0,0
"2011","Solihull","E08000029","Urban city and town",3570,3561,9,0
"2011","Solihull","E08000029","Urban city and town in a sparse setting",0,0,0,0
"2011","Solihull","E08000029","Rural (total)",20398,20325,73,0
"2011","Solihull","E08000029","Rural town and fringe",14388,14380,8,0
"2011","Solihull","E08000029","Rural town and fringe in a sparse setting",0,0,0,0
"2011","Solihull","E08000029","Rural village",2454,2454,0,0
"2011","Solihull","E08000029","Rural village in a sparse setting",0,0,0,0
"2011","Solihull","E08000029","Rural hamlet and isolated dwellings",3556,3491,65,0
"2011","Solihull","E08000029","Rural hamlet and isolated dwellings in a sparse setting",0,0,0,0
"2011","Walsall","E08000030","Total",269323,267397,1926,1
"2011","Walsall","E08000030","Urban (total)",266318,264486,1832,0
"2011","Walsall","E08000030","Urban major conurbation",265682,263850,1832,0
"2011","Walsall","E08000030","Urban minor conurbation",0,0,0,0
"2011","Walsall","E08000030","Urban city and town",636,636,0,0
"2011","Walsall","E08000030","Urban city and town in a sparse setting",0,0,0,0
"2011","Walsall","E08000030","Rural (total)",3005,2911,94,1
"2011","Walsall","E08000030","Rural town and fringe",2169,2134,35,0
"2011","Walsall","E08000030","Rural town and fringe in a sparse setting",0,0,0,0
"2011","Walsall","E08000030","Rural village",725,666,59,1
"2011","Walsall","E08000030","Rural village in a sparse setting",0,0,0,0
"2011","Walsall","E08000030","Rural hamlet and isolated dwellings",111,111,0,0
"2011","Walsall","E08000030","Rural hamlet and isolated dwellings in a sparse setting",0,0,0,0
"2011","Wolverhampton","E08000031","Total",249470,245526,3944,4
"2011","Wolverhampton","E08000031","Urban (total)",249470,245526,3944,4
"2011","Wolverhampton","E08000031","Urban major conurbation",249470,245526,3944,4
"2011","Wolverhampton","E08000031","Urban minor conurbation",0,0,0,0
"2011","Wolverhampton","E08000031","Urban city and town",0,0,0,0
"2011","Wolverhampton","E08000031","Urban city and town in a sparse setting",0,0,0,0
"2011","Wolverhampton","E08000031","Rural (total)",0,0,0,0
"2011","Wolverhampton","E08000031","Rural town and fringe",0,0,0,0
"2011","Wolverhampton","E08000031","Rural town and fringe in a sparse setting",0,0,0,0
"2011","Wolverhampton","E08000031","Rural village",0,0,0,0
"2011","Wolverhampton","E08000031","Rural village in a sparse setting",0,0,0,0
"2011","Wolverhampton","E08000031","Rural hamlet and isolated dwellings",0,0,0,0
"2011","Wolverhampton","E08000031","Rural hamlet and isolated dwellings in a sparse setting",0,0,0,0
"2011","Worcestershire","E10000034","Total",566169,556357,9812,2
"2011","Worcestershire","E10000034","Urban (total)",417021,411119,5902,2
"2011","Worcestershire","E10000034","Urban major conurbation",18896,18671,225,0
"2011","Worcestershire","E10000034","Urban minor conurbation",0,0,0,0
"2011","Worcestershire","E10000034","Urban city and town",398125,392448,5677,2
"2011","Worcestershire","E10000034","Urban city and town in a sparse setting",0,0,0,0
"2011","Worcestershire","E10000034","Rural (total)",149148,145238,3910,0
"2011","Worcestershire","E10000034","Rural town and fringe",50896,49440,1456,0
"2011","Worcestershire","E10000034","Rural town and fringe in a sparse setting",0,0,0,0
"2011","Worcestershire","E10000034","Rural village",55745,54848,897,0
"2011","Worcestershire","E10000034","Rural village in a sparse setting",0,0,0,0
"2011","Worcestershire","E10000034","Rural hamlet and isolated dwellings",42507,40950,1557,0
"2011","Worcestershire","E10000034","Rural hamlet and isolated dwellings in a sparse setting",0,0,0,0
"2011","Bedford","E06000055","Total",157479,154536,2943,0
"2011","Bedford","E06000055","Urban (total)",108375,105861,2514,0
"2011","Bedford","E06000055","Urban major conurbation",0,0,0,0
"2011","Bedford","E06000055","Urban minor conurbation",0,0,0,0
"2011","Bedford","E06000055","Urban city and town",108375,105861,2514,0
"2011","Bedford","E06000055","Urban city and town in a sparse setting",0,0,0,0
"2011","Bedford","E06000055","Rural (total)",49104,48675,429,0
"2011","Bedford","E06000055","Rural town and fringe",24877,24652,225,0
"2011","Bedford","E06000055","Rural town and fringe in a sparse setting",0,0,0,0
"2011","Bedford","E06000055","Rural village",16638,16493,145,0
"2011","Bedford","E06000055","Rural village in a sparse setting",0,0,0,0
"2011","Bedford","E06000055","Rural hamlet and isolated dwellings",7589,7530,59,0
"2011","Bedford","E06000055","Rural hamlet and isolated dwellings in a sparse setting",0,0,0,0
"2011","Central Bedfordshire","E06000056","Total",254381,252120,2261,0
"2011","Central Bedfordshire","E06000056","Urban (total)",154109,153185,924,0
"2011","Central Bedfordshire","E06000056","Urban major conurbation",0,0,0,0
"2011","Central Bedfordshire","E06000056","Urban minor conurbation",0,0,0,0
"2011","Central Bedfordshire","E06000056","Urban city and town",154109,153185,924,0
"2011","Central Bedfordshire","E06000056","Urban city and town in a sparse setting",0,0,0,0
"2011","Central Bedfordshire","E06000056","Rural (total)",100272,98935,1337,0
"2011","Central Bedfordshire","E06000056","Rural town and fringe",64306,63946,360,0
"2011","Central Bedfordshire","E06000056","Rural town and fringe in a sparse setting",0,0,0,0
"2011","Central Bedfordshire","E06000056","Rural village",27485,26630,855,0
"2011","Central Bedfordshire","E06000056","Rural village in a sparse setting",0,0,0,0
"2011","Central Bedfordshire","E06000056","Rural hamlet and isolated dwellings",8481,8359,122,0
"2011","Central Bedfordshire","E06000056","Rural hamlet and isolated dwellings in a sparse setting",0,0,0,0
"2011","Luton","E06000032","Total",203201,201549,1652,0
"2011","Luton","E06000032","Urban (total)",203201,201549,1652,0
"2011","Luton","E06000032","Urban major conurbation",0,0,0,0
"2011","Luton","E06000032","Urban minor conurbation",0,0,0,0
"2011","Luton","E06000032","Urban city and town",203201,201549,1652,0
"2011","Luton","E06000032","Urban city and town in a sparse setting",0,0,0,0
"2011","Luton","E06000032","Rural (total)",0,0,0,0
"2011","Luton","E06000032","Rural town and fringe",0,0,0,0
"2011","Luton","E06000032","Rural town and fringe in a sparse setting",0,0,0,0
"2011","Luton","E06000032","Rural village",0,0,0,0
"2011","Luton","E06000032","Rural village in a sparse setting",0,0,0,0
"2011","Luton","E06000032","Rural hamlet and isolated dwellings",0,0,0,0
"2011","Luton","E06000032","Rural hamlet and isolated dwellings in a sparse setting",0,0,0,0
"2011","Peterborough","E06000031","Total",183631,181827,1804,1
"2011","Peterborough","E06000031","Urban (total)",161879,160598,1281,1
"2011","Peterborough","E06000031","Urban major conurbation",0,0,0,0
"2011","Peterborough","E06000031","Urban minor conurbation",0,0,0,0
"2011","Peterborough","E06000031","Urban city and town",161879,160598,1281,1
"2011","Peterborough","E06000031","Urban city and town in a sparse setting",0,0,0,0
"2011","Peterborough","E06000031","Rural (total)",21752,21229,523,0
"2011","Peterborough","E06000031","Rural town and fringe",13618,13112,506,0
"2011","Peterborough","E06000031","Rural town and fringe in a sparse setting",0,0,0,0
"2011","Peterborough","E06000031","Rural village",6505,6490,15,0
"2011","Peterborough","E06000031","Rural village in a sparse setting",0,0,0,0
"2011","Peterborough","E06000031","Rural hamlet and isolated dwellings",1629,1627,2,0
"2011","Peterborough","E06000031","Rural hamlet and isolated dwellings in a sparse setting",0,0,0,0
"2011","Southend-on-Sea","E06000033","Total",173658,171489,2169,0
"2011","Southend-on-Sea","E06000033","Urban (total)",173658,171489,2169,0
"2011","Southend-on-Sea","E06000033","Urban major conurbation",0,0,0,0
"2011","Southend-on-Sea","E06000033","Urban minor conurbation",0,0,0,0
"2011","Southend-on-Sea","E06000033","Urban city and town",173658,171489,2169,0
"2011","Southend-on-Sea","E06000033","Urban city and town in a sparse setting",0,0,0,0
"2011","Southend-on-Sea","E06000033","Rural (total)",0,0,0,0
"2011","Southend-on-Sea","E06000033","Rural town and fringe",0,0,0,0
"2011","Southend-on-Sea","E06000033","Rural town and fringe in a sparse setting",0,0,0,0
"2011","Southend-on-Sea","E06000033","Rural village",0,0,0,0
"2011","Southend-on-Sea","E06000033","Rural village in a sparse setting",0,0,0,0
"2011","Southend-on-Sea","E06000033","Rural hamlet and isolated dwellings",0,0,0,0
"2011","Southend-on-Sea","E06000033","Rural hamlet and isolated dwellings in a sparse setting",0,0,0,0
"2011","Thurrock","E06000034","Total",157705,157072,633,0
"2011","Thurrock","E06000034","Urban (total)",137940,137345,595,0
"2011","Thurrock","E06000034","Urban major conurbation",105380,104914,466,0
"2011","Thurrock","E06000034","Urban minor conurbation",0,0,0,0
"2011","Thurrock","E06000034","Urban city and town",32560,32431,129,0
"2011","Thurrock","E06000034","Urban city and town in a sparse setting",0,0,0,0
"2011","Thurrock","E06000034","Rural (total)",19765,19727,38,0
"2011","Thurrock","E06000034","Rural town and fringe",16463,16450,13,0
"2011","Thurrock","E06000034","Rural town and fringe in a sparse setting",0,0,0,0
"2011","Thurrock","E06000034","Rural village",2727,2702,25,0
"2011","Thurrock","E06000034","Rural village in a sparse setting",0,0,0,0
"2011","Thurrock","E06000034","Rural hamlet and isolated dwellings",575,575,0,0
"2011","Thurrock","E06000034","Rural hamlet and isolated dwellings in a sparse setting",0,0,0,0
"2011","Cambridgeshire","E10000003","Total",621210,598066,23144,5
"2011","Cambridgeshire","E10000003","Urban (total)",328577,309573,19004,3
"2011","Cambridgeshire","E10000003","Urban major conurbation",0,0,0,0
"2011","Cambridgeshire","E10000003","Urban minor conurbation",0,0,0,0
"2011","Cambridgeshire","E10000003","Urban city and town",328577,309573,19004,3
"2011","Cambridgeshire","E10000003","Urban city and town in a sparse setting",0,0,0,0
"2011","Cambridgeshire","E10000003","Rural (total)",292633,288493,4140,2
"2011","Cambridgeshire","E10000003","Rural town and fringe",177303,175859,1444,1
"2011","Cambridgeshire","E10000003","Rural town and fringe in a sparse setting",0,0,0,0
"2011","Cambridgeshire","E10000003","Rural village",88356,85966,2390,1
"2011","Cambridgeshire","E10000003","Rural village in a sparse setting",0,0,0,0
"2011","Cambridgeshire","E10000003","Rural hamlet and isolated dwellings",26974,26668,306,0
"2011","Cambridgeshire","E10000003","Rural hamlet and isolated dwellings in a sparse setting",0,0,0,0
"2011","Essex","E10000012","Total",1393587,1375440,18147,3
"2011","Essex","E10000012","Urban (total)",1032982,1021293,11689,3
"2011","Essex","E10000012","Urban major conurbation",73097,72443,654,0
"2011","Essex","E10000012","Urban minor conurbation",0,0,0,0
"2011","Essex","E10000012","Urban city and town",959885,948850,11035,3
"2011","Essex","E10000012","Urban city and town in a sparse setting",0,0,0,0
"2011","Essex","E10000012","Rural (total)",360605,354147,6458,0
"2011","Essex","E10000012","Rural town and fringe",193057,191494,1563,0
"2011","Essex","E10000012","Rural town and fringe in a sparse setting",0,0,0,0
"2011","Essex","E10000012","Rural village",100321,98900,1421,0
"2011","Essex","E10000012","Rural village in a sparse setting",0,0,0,0
"2011","Essex","E10000012","Rural hamlet and isolated dwellings",67227,63753,3474,0
"2011","Essex","E10000012","Rural hamlet and isolated dwellings in a sparse setting",0,0,0,0
"2011","Hertfordshire","E10000015","Total",1116062,1101351,14711,2
"2011","Hertfordshire","E10000015","Urban (total)",987478,975648,11830,2
"2011","Hertfordshire","E10000015","Urban major conurbation",409182,405740,3442,1
"2011","Hertfordshire","E10000015","Urban minor conurbation",0,0,0,0
"2011","Hertfordshire","E10000015","Urban city and town",578296,569908,8388,1
"2011","Hertfordshire","E10000015","Urban city and town in a sparse setting",0,0,0,0
"2011","Hertfordshire","E10000015","Rural (total)",128584,125703,2881,0
"2011","Hertfordshire","E10000015","Rural town and fringe",59900,58873,1027,0
"2011","Hertfordshire","E10000015","Rural town and fringe in a sparse setting",0,0,0,0
"2011","Hertfordshire","E10000015","Rural village",47209,46528,681,0
"2011","Hertfordshire","E10000015","Rural village in a sparse setting",0,0,0,0
"2011","Hertfordshire","E10000015","Rural hamlet and isolated dwellings",21475,20302,1173,0
"2011","Hertfordshire","E10000015","Rural hamlet and isolated dwellings in a sparse setting",0,0,0,0
"2011","Norfolk","E10000020","Total",857888,841042,16846,3
"2011","Norfolk","E10000020","Urban (total)",429175,421095,8080,2
"2011","Norfolk","E10000020","Urban major conurbation",0,0,0,0
"2011","Norfolk","E10000020","Urban minor conurbation",0,0,0,0
"2011","Norfolk","E10000020","Urban city and town",429175,421095,8080,2
"2011","Norfolk","E10000020","Urban city and town in a sparse setting",0,0,0,0
"2011","Norfolk","E10000020","Rural (total)",428713,419947,8766,1
"2011","Norfolk","E10000020","Rural town and fringe",158559,155057,3502,0
"2011","Norfolk","E10000020","Rural town and fringe in a sparse setting",22696,22215,481,0
"2011","Norfolk","E10000020","Rural village",154966,151888,3078,0
"2011","Norfolk","E10000020","Rural village in a sparse setting",14033,13977,56,0
"2011","Norfolk","E10000020","Rural hamlet and isolated dwellings",74707,73061,1646,1
"2011","Norfolk","E10000020","Rural hamlet and isolated dwellings in a sparse setting",3752,3749,3,0
"2011","Suffolk","E10000029","Total",728163,714113,14050,0
"2011","Suffolk","E10000029","Urban (total)",439442,433954,5488,0
"2011","Suffolk","E10000029","Urban major conurbation",0,0,0,0
"2011","Suffolk","E10000029","Urban minor conurbation",0,0,0,0
"2011","Suffolk","E10000029","Urban city and town",439442,433954,5488,0
"2011","Suffolk","E10000029","Urban city and town in a sparse setting",0,0,0,0
"2011","Suffolk","E10000029","Rural (total)",288721,280159,8562,0
"2011","Suffolk","E10000029","Rural town and fringe",108310,106090,2220,0
"2011","Suffolk","E10000029","Rural town and fringe in a sparse setting",7421,7297,124,0
"2011","Suffolk","E10000029","Rural village",110597,106528,4069,0
"2011","Suffolk","E10000029","Rural village in a sparse setting",231,231,0,0
"2011","Suffolk","E10000029","Rural hamlet and isolated dwellings",61081,58979,2102,0
"2011","Suffolk","E10000029","Rural hamlet and isolated dwellings in a sparse setting",1081,1034,47,0
"2011","Camden","E09000007","Total",220338,212443,7895,0
"2011","Camden","E09000007","Urban (total)",220338,212443,7895,0
"2011","Camden","E09000007","Urban major conurbation",220338,212443,7895,0
"2011","Camden","E09000007","Urban minor conurbation",0,0,0,0
"2011","Camden","E09000007","Urban city and town",0,0,0,0
"2011","Camden","E09000007","Urban city and town in a sparse setting",0,0,0,0
"2011","Camden","E09000007","Rural (total)",0,0,0,0
"2011","Camden","E09000007","Rural town and fringe",0,0,0,0
"2011","Camden","E09000007","Rural town and fringe in a sparse setting",0,0,0,0
"2011","Camden","E09000007","Rural village",0,0,0,0
"2011","Camden","E09000007","Rural village in a sparse setting",0,0,0,0
"2011","Camden","E09000007","Rural hamlet and isolated dwellings",0,0,0,0
"2011","Camden","E09000007","Rural hamlet and isolated dwellings in a sparse setting",0,0,0,0
"2011","City of London","E09000001","Total",7375,7187,188,0
"2011","City of London","E09000001","Urban (total)",7375,7187,188,0
"2011","City of London","E09000001","Urban major conurbation",7375,7187,188,0
"2011","City of London","E09000001","Urban minor conurbation",0,0,0,0
"2011","City of London","E09000001","Urban city and town",0,0,0,0
"2011","City of London","E09000001","Urban city and town in a sparse setting",0,0,0,0
"2011","City of London","E09000001","Rural (total)",0,0,0,0
"2011","City of London","E09000001","Rural town and fringe",0,0,0,0
"2011","City of London","E09000001","Rural town and fringe in a sparse setting",0,0,0,0
"2011","City of London","E09000001","Rural village",0,0,0,0
"2011","City of London","E09000001","Rural village in a sparse setting",0,0,0,0
"2011","City of London","E09000001","Rural hamlet and isolated dwellings",0,0,0,0
"2011","City of London","E09000001","Rural hamlet and isolated dwellings in a sparse setting",0,0,0,0
"2011","Hackney","E09000012","Total",246270,244433,1837,0
"2011","Hackney","E09000012","Urban (total)",245645,243808,1837,0
"2011","Hackney","E09000012","Urban major conurbation",245645,243808,1837,0
"2011","Hackney","E09000012","Urban minor conurbation",0,0,0,0
"2011","Hackney","E09000012","Urban city and town",0,0,0,0
"2011","Hackney","E09000012","Urban city and town in a sparse setting",0,0,0,0
"2011","Hackney","E09000012","Rural (total)",625,625,0,0
"2011","Hackney","E09000012","Rural town and fringe",625,625,0,0
"2011","Hackney","E09000012","Rural town and fringe in a sparse setting",0,0,0,0
"2011","Hackney","E09000012","Rural village",0,0,0,0
"2011","Hackney","E09000012","Rural village in a sparse setting",0,0,0,0
"2011","Hackney","E09000012","Rural hamlet and isolated dwellings",0,0,0,0
"2011","Hackney","E09000012","Rural hamlet and isolated dwellings in a sparse setting",0,0,0,0
"2011","Hammersmith and Fulham","E09000013","Total",182493,180652,1841,0
"2011","Hammersmith and Fulham","E09000013","Urban (total)",182493,180652,1841,0
"2011","Hammersmith and Fulham","E09000013","Urban major conurbation",182493,180652,1841,0
"2011","Hammersmith and Fulham","E09000013","Urban minor conurbation",0,0,0,0
"2011","Hammersmith and Fulham","E09000013","Urban city and town",0,0,0,0
"2011","Hammersmith and Fulham","E09000013","Urban city and town in a sparse setting",0,0,0,0
"2011","Hammersmith and Fulham","E09000013","Rural (total)",0,0,0,0
"2011","Hammersmith and Fulham","E09000013","Rural town and fringe",0,0,0,0
"2011","Hammersmith and Fulham","E09000013","Rural town and fringe in a sparse setting",0,0,0,0
"2011","Hammersmith and Fulham","E09000013","Rural village",0,0,0,0
"2011","Hammersmith and Fulham","E09000013","Rural village in a sparse setting",0,0,0,0
"2011","Hammersmith and Fulham","E09000013","Rural hamlet and isolated dwellings",0,0,0,0
"2011","Hammersmith and Fulham","E09000013","Rural hamlet and isolated dwellings in a sparse setting",0,0,0,0
"2011","Haringey","E09000014","Total",254926,253236,1690,0
"2011","Haringey","E09000014","Urban (total)",254926,253236,1690,0
"2011","Haringey","E09000014","Urban major conurbation",254926,253236,1690,0
"2011","Haringey","E09000014","Urban minor conurbation",0,0,0,0
"2011","Haringey","E09000014","Urban city and town",0,0,0,0
"2011","Haringey","E09000014","Urban city and town in a sparse setting",0,0,0,0
"2011","Haringey","E09000014","Rural (total)",0,0,0,0
"2011","Haringey","E09000014","Rural town and fringe",0,0,0,0
"2011","Haringey","E09000014","Rural town and fringe in a sparse setting",0,0,0,0
"2011","Haringey","E09000014","Rural village",0,0,0,0
"2011","Haringey","E09000014","Rural village in a sparse setting",0,0,0,0
"2011","Haringey","E09000014","Rural hamlet and isolated dwellings",0,0,0,0
"2011","Haringey","E09000014","Rural hamlet and isolated dwellings in a sparse setting",0,0,0,0
"2011","Islington","E09000019","Total",206125,200134,5991,0
"2011","Islington","E09000019","Urban (total)",206125,200134,5991,0
"2011","Islington","E09000019","Urban major conurbation",206125,200134,5991,0
"2011","Islington","E09000019","Urban minor conurbation",0,0,0,0
"2011","Islington","E09000019","Urban city and town",0,0,0,0
"2011","Islington","E09000019","Urban city and town in a sparse setting",0,0,0,0
"2011","Islington","E09000019","Rural (total)",0,0,0,0
"2011","Islington","E09000019","Rural town and fringe",0,0,0,0
"2011","Islington","E09000019","Rural town and fringe in a sparse setting",0,0,0,0
"2011","Islington","E09000019","Rural village",0,0,0,0
"2011","Islington","E09000019","Rural village in a sparse setting",0,0,0,0
"2011","Islington","E09000019","Rural hamlet and isolated dwellings",0,0,0,0
"2011","Islington","E09000019","Rural hamlet and isolated dwellings in a sparse setting",0,0,0,0
"2011","Kensington and Chelsea","E09000020","Total",158649,155939,2710,1
"2011","Kensington and Chelsea","E09000020","Urban (total)",158649,155939,2710,1
"2011","Kensington and Chelsea","E09000020","Urban major conurbation",158649,155939,2710,1
"2011","Kensington and Chelsea","E09000020","Urban minor conurbation",0,0,0,0
"2011","Kensington and Chelsea","E09000020","Urban city and town",0,0,0,0
"2011","Kensington and Chelsea","E09000020","Urban city and town in a sparse setting",0,0,0,0
"2011","Kensington and Chelsea","E09000020","Rural (total)",0,0,0,0
"2011","Kensington and Chelsea","E09000020","Rural town and fringe",0,0,0,0
"2011","Kensington and Chelsea","E09000020","Rural town and fringe in a sparse setting",0,0,0,0
"2011","Kensington and Chelsea","E09000020","Rural village",0,0,0,0
"2011","Kensington and Chelsea","E09000020","Rural village in a sparse setting",0,0,0,0
"2011","Kensington and Chelsea","E09000020","Rural hamlet and isolated dwellings",0,0,0,0
"2011","Kensington and Chelsea","E09000020","Rural hamlet and isolated dwellings in a sparse setting",0,0,0,0
"2011","Lambeth","E09000022","Total",303086,300101,2985,2
"2011","Lambeth","E09000022","Urban (total)",303086,300101,2985,2
"2011","Lambeth","E09000022","Urban major conurbation",303086,300101,2985,2
"2011","Lambeth","E09000022","Urban minor conurbation",0,0,0,0
"2011","Lambeth","E09000022","Urban city and town",0,0,0,0
"2011","Lambeth","E09000022","Urban city and town in a sparse setting",0,0,0,0
"2011","Lambeth","E09000022","Rural (total)",0,0,0,0
"2011","Lambeth","E09000022","Rural town and fringe",0,0,0,0
"2011","Lambeth","E09000022","Rural town and fringe in a sparse setting",0,0,0,0
"2011","Lambeth","E09000022","Rural village",0,0,0,0
"2011","Lambeth","E09000022","Rural village in a sparse setting",0,0,0,0
"2011","Lambeth","E09000022","Rural hamlet and isolated dwellings",0,0,0,0
"2011","Lambeth","E09000022","Rural hamlet and isolated dwellings in a sparse setting",0,0,0,0
"2011","Lewisham","E09000023","Total",275885,273342,2543,1
"2011","Lewisham","E09000023","Urban (total)",275885,273342,2543,1
"2011","Lewisham","E09000023","Urban major conurbation",275885,273342,2543,1
"2011","Lewisham","E09000023","Urban minor conurbation",0,0,0,0
"2011","Lewisham","E09000023","Urban city and town",0,0,0,0
"2011","Lewisham","E09000023","Urban city and town in a sparse setting",0,0,0,0
"2011","Lewisham","E09000023","Rural (total)",0,0,0,0
"2011","Lewisham","E09000023","Rural town and fringe",0,0,0,0
"2011","Lewisham","E09000023","Rural town and fringe in a sparse setting",0,0,0,0
"2011","Lewisham","E09000023","Rural village",0,0,0,0
"2011","Lewisham","E09000023","Rural village in a sparse setting",0,0,0,0
"2011","Lewisham","E09000023","Rural hamlet and isolated dwellings",0,0,0,0
"2011","Lewisham","E09000023","Rural hamlet and isolated dwellings in a sparse setting",0,0,0,0
"2011","Newham","E09000025","Total",307984,306009,1975,1
"2011","Newham","E09000025","Urban (total)",307984,306009,1975,1
"2011","Newham","E09000025","Urban major conurbation",307984,306009,1975,1
"2011","Newham","E09000025","Urban minor conurbation",0,0,0,0
"2011","Newham","E09000025","Urban city and town",0,0,0,0
"2011","Newham","E09000025","Urban city and town in a sparse setting",0,0,0,0
"2011","Newham","E09000025","Rural (total)",0,0,0,0
"2011","Newham","E09000025","Rural town and fringe",0,0,0,0
"2011","Newham","E09000025","Rural town and fringe in a sparse setting",0,0,0,0
"2011","Newham","E09000025","Rural village",0,0,0,0
"2011","Newham","E09000025","Rural village in a sparse setting",0,0,0,0
"2011","Newham","E09000025","Rural hamlet and isolated dwellings",0,0,0,0
"2011","Newham","E09000025","Rural hamlet and isolated dwellings in a sparse setting",0,0,0,0
"2011","Southwark","E09000028","Total",288283,282560,5723,1
"2011","Southwark","E09000028","Urban (total)",288283,282560,5723,1
"2011","Southwark","E09000028","Urban major conurbation",288283,282560,5723,1
"2011","Southwark","E09000028","Urban minor conurbation",0,0,0,0
"2011","Southwark","E09000028","Urban city and town",0,0,0,0
"2011","Southwark","E09000028","Urban city and town in a sparse setting",0,0,0,0
"2011","Southwark","E09000028","Rural (total)",0,0,0,0
"2011","Southwark","E09000028","Rural town and fringe",0,0,0,0
"2011","Southwark","E09000028","Rural town and fringe in a sparse setting",0,0,0,0
"2011","Southwark","E09000028","Rural village",0,0,0,0
"2011","Southwark","E09000028","Rural village in a sparse setting",0,0,0,0
"2011","Southwark","E09000028","Rural hamlet and isolated dwellings",0,0,0,0
"2011","Southwark","E09000028","Rural hamlet and isolated dwellings in a sparse setting",0,0,0,0
"2011","Tower Hamlets","E09000030","Total",254096,250343,3753,0
"2011","Tower Hamlets","E09000030","Urban (total)",254096,250343,3753,0
"2011","Tower Hamlets","E09000030","Urban major conurbation",254096,250343,3753,0
"2011","Tower Hamlets","E09000030","Urban minor conurbation",0,0,0,0
"2011","Tower Hamlets","E09000030","Urban city and town",0,0,0,0
"2011","Tower Hamlets","E09000030","Urban city and town in a sparse setting",0,0,0,0
"2011","Tower Hamlets","E09000030","Rural (total)",0,0,0,0
"2011","Tower Hamlets","E09000030","Rural town and fringe",0,0,0,0
"2011","Tower Hamlets","E09000030","Rural town and fringe in a sparse setting",0,0,0,0
"2011","Tower Hamlets","E09000030","Rural village",0,0,0,0
"2011","Tower Hamlets","E09000030","Rural village in a sparse setting",0,0,0,0
"2011","Tower Hamlets","E09000030","Rural hamlet and isolated dwellings",0,0,0,0
"2011","Tower Hamlets","E09000030","Rural hamlet and isolated dwellings in a sparse setting",0,0,0,0
"2011","Wandsworth","E09000032","Total",306995,301648,5347,0
"2011","Wandsworth","E09000032","Urban (total)",306995,301648,5347,0
"2011","Wandsworth","E09000032","Urban major conurbation",306995,301648,5347,0
"2011","Wandsworth","E09000032","Urban minor conurbation",0,0,0,0
"2011","Wandsworth","E09000032","Urban city and town",0,0,0,0
"2011","Wandsworth","E09000032","Urban city and town in a sparse setting",0,0,0,0
"2011","Wandsworth","E09000032","Rural (total)",0,0,0,0
"2011","Wandsworth","E09000032","Rural town and fringe",0,0,0,0
"2011","Wandsworth","E09000032","Rural town and fringe in a sparse setting",0,0,0,0
"2011","Wandsworth","E09000032","Rural village",0,0,0,0
"2011","Wandsworth","E09000032","Rural village in a sparse setting",0,0,0,0
"2011","Wandsworth","E09000032","Rural hamlet and isolated dwellings",0,0,0,0
"2011","Wandsworth","E09000032","Rural hamlet and isolated dwellings in a sparse setting",0,0,0,0
"2011","Westminster","E09000033","Total",219396,213208,6188,2
"2011","Westminster","E09000033","Urban (total)",219396,213208,6188,2
"2011","Westminster","E09000033","Urban major conurbation",219396,213208,6188,2
"2011","Westminster","E09000033","Urban minor conurbation",0,0,0,0
"2011","Westminster","E09000033","Urban city and town",0,0,0,0
"2011","Westminster","E09000033","Urban city and town in a sparse setting",0,0,0,0
"2011","Westminster","E09000033","Rural (total)",0,0,0,0
"2011","Westminster","E09000033","Rural town and fringe",0,0,0,0
"2011","Westminster","E09000033","Rural town and fringe in a sparse setting",0,0,0,0
"2011","Westminster","E09000033","Rural village",0,0,0,0
"2011","Westminster","E09000033","Rural village in a sparse setting",0,0,0,0
"2011","Westminster","E09000033","Rural hamlet and isolated dwellings",0,0,0,0
"2011","Westminster","E09000033","Rural hamlet and isolated dwellings in a sparse setting",0,0,0,0
"2011","Barking and Dagenham","E09000002","Total",185911,184901,1010,0
"2011","Barking and Dagenham","E09000002","Urban (total)",185911,184901,1010,0
"2011","Barking and Dagenham","E09000002","Urban major conurbation",185911,184901,1010,0
"2011","Barking and Dagenham","E09000002","Urban minor conurbation",0,0,0,0
"2011","Barking and Dagenham","E09000002","Urban city and town",0,0,0,0
"2011","Barking and Dagenham","E09000002","Urban city and town in a sparse setting",0,0,0,0
"2011","Barking and Dagenham","E09000002","Rural (total)",0,0,0,0
"2011","Barking and Dagenham","E09000002","Rural town and fringe",0,0,0,0
"2011","Barking and Dagenham","E09000002","Rural town and fringe in a sparse setting",0,0,0,0
"2011","Barking and Dagenham","E09000002","Rural village",0,0,0,0
"2011","Barking and Dagenham","E09000002","Rural village in a sparse setting",0,0,0,0
"2011","Barking and Dagenham","E09000002","Rural hamlet and isolated dwellings",0,0,0,0
"2011","Barking and Dagenham","E09000002","Rural hamlet and isolated dwellings in a sparse setting",0,0,0,0
"2011","Barnet","E09000003","Total",356386,352597,3789,1
"2011","Barnet","E09000003","Urban (total)",356386,352597,3789,1
"2011","Barnet","E09000003","Urban major conurbation",355633,351847,3786,1
"2011","Barnet","E09000003","Urban minor conurbation",0,0,0,0
"2011","Barnet","E09000003","Urban city and town",753,750,3,0
"2011","Barnet","E09000003","Urban city and town in a sparse setting",0,0,0,0
"2011","Barnet","E09000003","Rural (total)",0,0,0,0
"2011","Barnet","E09000003","Rural town and fringe",0,0,0,0
"2011","Barnet","E09000003","Rural town and fringe in a sparse setting",0,0,0,0
"2011","Barnet","E09000003","Rural village",0,0,0,0
"2011","Barnet","E09000003","Rural village in a sparse setting",0,0,0,0
"2011","Barnet","E09000003","Rural hamlet and isolated dwellings",0,0,0,0
"2011","Barnet","E09000003","Rural hamlet and isolated dwellings in a sparse setting",0,0,0,0
"2011","Bexley","E09000004","Total",231997,230902,1095,1
"2011","Bexley","E09000004","Urban (total)",231845,230769,1076,1
"2011","Bexley","E09000004","Urban major conurbation",231845,230769,1076,1
"2011","Bexley","E09000004","Urban minor conurbation",0,0,0,0
"2011","Bexley","E09000004","Urban city and town",0,0,0,0
"2011","Bexley","E09000004","Urban city and town in a sparse setting",0,0,0,0
"2011","Bexley","E09000004","Rural (total)",152,133,19,0
"2011","Bexley","E09000004","Rural town and fringe",0,0,0,0
"2011","Bexley","E09000004","Rural town and fringe in a sparse setting",0,0,0,0
"2011","Bexley","E09000004","Rural village",0,0,0,0
"2011","Bexley","E09000004","Rural village in a sparse setting",0,0,0,0
"2011","Bexley","E09000004","Rural hamlet and isolated dwellings",152,133,19,0
"2011","Bexley","E09000004","Rural hamlet and isolated dwellings in a sparse setting",0,0,0,0
"2011","Brent","E09000005","Total",311215,308895,2320,1
"2011","Brent","E09000005","Urban (total)",311215,308895,2320,1
"2011","Brent","E09000005","Urban major conurbation",311215,308895,2320,1
"2011","Brent","E09000005","Urban minor conurbation",0,0,0,0
"2011","Brent","E09000005","Urban city and town",0,0,0,0
"2011","Brent","E09000005","Urban city and town in a sparse setting",0,0,0,0
"2011","Brent","E09000005","Rural (total)",0,0,0,0
"2011","Brent","E09000005","Rural town and fringe",0,0,0,0
"2011","Brent","E09000005","Rural town and fringe in a sparse setting",0,0,0,0
"2011","Brent","E09000005","Rural village",0,0,0,0
"2011","Brent","E09000005","Rural village in a sparse setting",0,0,0,0
"2011","Brent","E09000005","Rural hamlet and isolated dwellings",0,0,0,0
"2011","Brent","E09000005","Rural hamlet and isolated dwellings in a sparse setting",0,0,0,0
"2011","Bromley","E09000006","Total",309392,307023,2369,0
"2011","Bromley","E09000006","Urban (total)",305937,303578,2359,0
"2011","Bromley","E09000006","Urban major conurbation",291763,289417,2346,0
"2011","Bromley","E09000006","Urban minor conurbation",0,0,0,0
"2011","Bromley","E09000006","Urban city and town",14174,14161,13,0
"2011","Bromley","E09000006","Urban city and town in a sparse setting",0,0,0,0
"2011","Bromley","E09000006","Rural (total)",3455,3445,10,0
"2011","Bromley","E09000006","Rural town and fringe",603,593,10,0
"2011","Bromley","E09000006","Rural town and fringe in a sparse setting",0,0,0,0
"2011","Bromley","E09000006","Rural village",1698,1698,0,0
"2011","Bromley","E09000006","Rural village in a sparse setting",0,0,0,0
"2011","Bromley","E09000006","Rural hamlet and isolated dwellings",1154,1154,0,0
"2011","Bromley","E09000006","Rural hamlet and isolated dwellings in a sparse setting",0,0,0,0
"2011","Croydon","E09000008","Total",363378,360230,3148,0
"2011","Croydon","E09000008","Urban (total)",363378,360230,3148,0
"2011","Croydon","E09000008","Urban major conurbation",363378,360230,3148,0
"2011","Croydon","E09000008","Urban minor conurbation",0,0,0,0
"2011","Croydon","E09000008","Urban city and town",0,0,0,0
"2011","Croydon","E09000008","Urban city and town in a sparse setting",0,0,0,0
"2011","Croydon","E09000008","Rural (total)",0,0,0,0
"2011","Croydon","E09000008","Rural town and fringe",0,0,0,0
"2011","Croydon","E09000008","Rural town and fringe in a sparse setting",0,0,0,0
"2011","Croydon","E09000008","Rural village",0,0,0,0
"2011","Croydon","E09000008","Rural village in a sparse setting",0,0,0,0
"2011","Croydon","E09000008","Rural hamlet and isolated dwellings",0,0,0,0
"2011","Croydon","E09000008","Rural hamlet and isolated dwellings in a sparse setting",0,0,0,0
"2011","Ealing","E09000009","Total",338449,334725,3724,0
"2011","Ealing","E09000009","Urban (total)",338449,334725,3724,0
"2011","Ealing","E09000009","Urban major conurbation",338449,334725,3724,0
"2011","Ealing","E09000009","Urban minor conurbation",0,0,0,0
"2011","Ealing","E09000009","Urban city and town",0,0,0,0
"2011","Ealing","E09000009","Urban city and town in a sparse setting",0,0,0,0
"2011","Ealing","E09000009","Rural (total)",0,0,0,0
"2011","Ealing","E09000009","Rural town and fringe",0,0,0,0
"2011","Ealing","E09000009","Rural town and fringe in a sparse setting",0,0,0,0
"2011","Ealing","E09000009","Rural village",0,0,0,0
"2011","Ealing","E09000009","Rural village in a sparse setting",0,0,0,0
"2011","Ealing","E09000009","Rural hamlet and isolated dwellings",0,0,0,0
"2011","Ealing","E09000009","Rural hamlet and isolated dwellings in a sparse setting",0,0,0,0
"2011","Enfield","E09000010","Total",312466,310066,2400,0
"2011","Enfield","E09000010","Urban (total)",310988,308825,2163,0
"2011","Enfield","E09000010","Urban major conurbation",309171,307045,2126,0
"2011","Enfield","E09000010","Urban minor conurbation",0,0,0,0
"2011","Enfield","E09000010","Urban city and town",1817,1780,37,0
"2011","Enfield","E09000010","Urban city and town in a sparse setting",0,0,0,0
"2011","Enfield","E09000010","Rural (total)",1478,1241,237,0
"2011","Enfield","E09000010","Rural town and fringe",0,0,0,0
"2011","Enfield","E09000010","Rural town and fringe in a sparse setting",0,0,0,0
"2011","Enfield","E09000010","Rural village",1064,827,237,0
"2011","Enfield","E09000010","Rural village in a sparse setting",0,0,0,0
"2011","Enfield","E09000010","Rural hamlet and isolated dwellings",414,414,0,0
"2011","Enfield","E09000010","Rural hamlet and isolated dwellings in a sparse setting",0,0,0,0
"2011","Greenwich","E09000011","Total",254557,249991,4566,0
"2011","Greenwich","E09000011","Urban (total)",254557,249991,4566,0
"2011","Greenwich","E09000011","Urban major conurbation",254557,249991,4566,0
"2011","Greenwich","E09000011","Urban minor conurbation",0,0,0,0
"2011","Greenwich","E09000011","Urban city and town",0,0,0,0
"2011","Greenwich","E09000011","Urban city and town in a sparse setting",0,0,0,0
"2011","Greenwich","E09000011","Rural (total)",0,0,0,0
"2011","Greenwich","E09000011","Rural town and fringe",0,0,0,0
"2011","Greenwich","E09000011","Rural town and fringe in a sparse setting",0,0,0,0
"2011","Greenwich","E09000011","Rural village",0,0,0,0
"2011","Greenwich","E09000011","Rural village in a sparse setting",0,0,0,0
"2011","Greenwich","E09000011","Rural hamlet and isolated dwellings",0,0,0,0
"2011","Greenwich","E09000011","Rural hamlet and isolated dwellings in a sparse setting",0,0,0,0
"2011","Harrow","E09000015","Total",239056,236970,2086,0
"2011","Harrow","E09000015","Urban (total)",238455,236372,2083,0
"2011","Harrow","E09000015","Urban major conurbation",238455,236372,2083,0
"2011","Harrow","E09000015","Urban minor conurbation",0,0,0,0
"2011","Harrow","E09000015","Urban city and town",0,0,0,0
"2011","Harrow","E09000015","Urban city and town in a sparse setting",0,0,0,0
"2011","Harrow","E09000015","Rural (total)",601,598,3,0
"2011","Harrow","E09000015","Rural town and fringe",0,0,0,0
"2011","Harrow","E09000015","Rural town and fringe in a sparse setting",0,0,0,0
"2011","Harrow","E09000015","Rural village",601,598,3,0
"2011","Harrow","E09000015","Rural village in a sparse setting",0,0,0,0
"2011","Harrow","E09000015","Rural hamlet and isolated dwellings",0,0,0,0
"2011","Harrow","E09000015","Rural hamlet and isolated dwellings in a sparse setting",0,0,0,0
"2011","Havering","E09000016","Total",237232,235671,1561,1
"2011","Havering","E09000016","Urban (total)",235372,233929,1443,1
"2011","Havering","E09000016","Urban major conurbation",234684,233263,1421,1
"2011","Havering","E09000016","Urban minor conurbation",0,0,0,0
"2011","Havering","E09000016","Urban city and town",688,666,22,0
"2011","Havering","E09000016","Urban city and town in a sparse setting",0,0,0,0
"2011","Havering","E09000016","Rural (total)",1860,1742,118,0
"2011","Havering","E09000016","Rural town and fringe",512,512,0,0
"2011","Havering","E09000016","Rural town and fringe in a sparse setting",0,0,0,0
"2011","Havering","E09000016","Rural village",259,255,4,0
"2011","Havering","E09000016","Rural village in a sparse setting",0,0,0,0
"2011","Havering","E09000016","Rural hamlet and isolated dwellings",1089,975,114,0
"2011","Havering","E09000016","Rural hamlet and isolated dwellings in a sparse setting",0,0,0,0
"2011","Hillingdon","E09000017","Total",273936,267227,6709,0
"2011","Hillingdon","E09000017","Urban (total)",266537,260046,6491,0
"2011","Hillingdon","E09000017","Urban major conurbation",263476,257268,6208,0
"2011","Hillingdon","E09000017","Urban minor conurbation",0,0,0,0
"2011","Hillingdon","E09000017","Urban city and town",3061,2778,283,0
"2011","Hillingdon","E09000017","Urban city and town in a sparse setting",0,0,0,0
"2011","Hillingdon","E09000017","Rural (total)",7399,7181,218,0
"2011","Hillingdon","E09000017","Rural town and fringe",6416,6248,168,0
"2011","Hillingdon","E09000017","Rural town and fringe in a sparse setting",0,0,0,0
"2011","Hillingdon","E09000017","Rural village",865,815,50,0
"2011","Hillingdon","E09000017","Rural village in a sparse setting",0,0,0,0
"2011","Hillingdon","E09000017","Rural hamlet and isolated dwellings",118,118,0,0
"2011","Hillingdon","E09000017","Rural hamlet and isolated dwellings in a sparse setting",0,0,0,0
"2011","Hounslow","E09000018","Total",253957,251961,1996,2
"2011","Hounslow","E09000018","Urban (total)",253957,251961,1996,2
"2011","Hounslow","E09000018","Urban major conurbation",253957,251961,1996,2
"2011","Hounslow","E09000018","Urban minor conurbation",0,0,0,0
"2011","Hounslow","E09000018","Urban city and town",0,0,0,0
"2011","Hounslow","E09000018","Urban city and town in a sparse setting",0,0,0,0
"2011","Hounslow","E09000018","Rural (total)",0,0,0,0
"2011","Hounslow","E09000018","Rural town and fringe",0,0,0,0
"2011","Hounslow","E09000018","Rural town and fringe in a sparse setting",0,0,0,0
"2011","Hounslow","E09000018","Rural village",0,0,0,0
"2011","Hounslow","E09000018","Rural village in a sparse setting",0,0,0,0
"2011","Hounslow","E09000018","Rural hamlet and isolated dwellings",0,0,0,0
"2011","Hounslow","E09000018","Rural hamlet and isolated dwellings in a sparse setting",0,0,0,0
"2011","Kingston upon Thames","E09000021","Total",160060,156358,3702,0
"2011","Kingston upon Thames","E09000021","Urban (total)",159636,155934,3702,0
"2011","Kingston upon Thames","E09000021","Urban major conurbation",156986,153645,3341,0
"2011","Kingston upon Thames","E09000021","Urban minor conurbation",0,0,0,0
"2011","Kingston upon Thames","E09000021","Urban city and town",2650,2289,361,0
"2011","Kingston upon Thames","E09000021","Urban city and town in a sparse setting",0,0,0,0
"2011","Kingston upon Thames","E09000021","Rural (total)",424,424,0,0
"2011","Kingston upon Thames","E09000021","Rural town and fringe",0,0,0,0
"2011","Kingston upon Thames","E09000021","Rural town and fringe in a sparse setting",0,0,0,0
"2011","Kingston upon Thames","E09000021","Rural village",424,424,0,0
"2011","Kingston upon Thames","E09000021","Rural village in a sparse setting",0,0,0,0
"2011","Kingston upon Thames","E09000021","Rural hamlet and isolated dwellings",0,0,0,0
"2011","Kingston upon Thames","E09000021","Rural hamlet and isolated dwellings in a sparse setting",0,0,0,0
"2011","Merton","E09000024","Total",199693,198217,1476,1
"2011","Merton","E09000024","Urban (total)",199693,198217,1476,1
"2011","Merton","E09000024","Urban major conurbation",199693,198217,1476,1
"2011","Merton","E09000024","Urban minor conurbation",0,0,0,0
"2011","Merton","E09000024","Urban city and town",0,0,0,0
"2011","Merton","E09000024","Urban city and town in a sparse setting",0,0,0,0
"2011","Merton","E09000024","Rural (total)",0,0,0,0
"2011","Merton","E09000024","Rural town and fringe",0,0,0,0
"2011","Merton","E09000024","Rural town and fringe in a sparse setting",0,0,0,0
"2011","Merton","E09000024","Rural village",0,0,0,0
"2011","Merton","E09000024","Rural village in a sparse setting",0,0,0,0
"2011","Merton","E09000024","Rural hamlet and isolated dwellings",0,0,0,0
"2011","Merton","E09000024","Rural hamlet and isolated dwellings in a sparse setting",0,0,0,0
"2011","Redbridge","E09000026","Total",278970,277323,1647,1
"2011","Redbridge","E09000026","Urban (total)",278970,277323,1647,1
"2011","Redbridge","E09000026","Urban major conurbation",278970,277323,1647,1
"2011","Redbridge","E09000026","Urban minor conurbation",0,0,0,0
"2011","Redbridge","E09000026","Urban city and town",0,0,0,0
"2011","Redbridge","E09000026","Urban city and town in a sparse setting",0,0,0,0
"2011","Redbridge","E09000026","Rural (total)",0,0,0,0
"2011","Redbridge","E09000026","Rural town and fringe",0,0,0,0
"2011","Redbridge","E09000026","Rural town and fringe in a sparse setting",0,0,0,0
"2011","Redbridge","E09000026","Rural village",0,0,0,0
"2011","Redbridge","E09000026","Rural village in a sparse setting",0,0,0,0
"2011","Redbridge","E09000026","Rural hamlet and isolated dwellings",0,0,0,0
"2011","Redbridge","E09000026","Rural hamlet and isolated dwellings in a sparse setting",0,0,0,0
"2011","Richmond upon Thames","E09000027","Total",186990,184098,2892,1
"2011","Richmond upon Thames","E09000027","Urban (total)",186990,184098,2892,1
"2011","Richmond upon Thames","E09000027","Urban major conurbation",186990,184098,2892,1
"2011","Richmond upon Thames","E09000027","Urban minor conurbation",0,0,0,0
"2011","Richmond upon Thames","E09000027","Urban city and town",0,0,0,0
"2011","Richmond upon Thames","E09000027","Urban city and town in a sparse setting",0,0,0,0
"2011","Richmond upon Thames","E09000027","Rural (total)",0,0,0,0
"2011","Richmond upon Thames","E09000027","Rural town and fringe",0,0,0,0
"2011","Richmond upon Thames","E09000027","Rural town and fringe in a sparse setting",0,0,0,0
"2011","Richmond upon Thames","E09000027","Rural village",0,0,0,0
"2011","Richmond upon Thames","E09000027","Rural village in a sparse setting",0,0,0,0
"2011","Richmond upon Thames","E09000027","Rural hamlet and isolated dwellings",0,0,0,0
"2011","Richmond upon Thames","E09000027","Rural hamlet and isolated dwellings in a sparse setting",0,0,0,0
"2011","Sutton","E09000029","Total",190146,188695,1451,0
"2011","Sutton","E09000029","Urban (total)",190146,188695,1451,0
"2011","Sutton","E09000029","Urban major conurbation",189719,188337,1382,0
"2011","Sutton","E09000029","Urban minor conurbation",0,0,0,0
"2011","Sutton","E09000029","Urban city and town",427,358,69,0
"2011","Sutton","E09000029","Urban city and town in a sparse setting",0,0,0,0
"2011","Sutton","E09000029","Rural (total)",0,0,0,0
"2011","Sutton","E09000029","Rural town and fringe",0,0,0,0
"2011","Sutton","E09000029","Rural town and fringe in a sparse setting",0,0,0,0
"2011","Sutton","E09000029","Rural village",0,0,0,0
"2011","Sutton","E09000029","Rural village in a sparse setting",0,0,0,0
"2011","Sutton","E09000029","Rural hamlet and isolated dwellings",0,0,0,0
"2011","Sutton","E09000029","Rural hamlet and isolated dwellings in a sparse setting",0,0,0,0
"2011","Waltham Forest","E09000031","Total",258249,256615,1634,0
"2011","Waltham Forest","E09000031","Urban (total)",258249,256615,1634,0
"2011","Waltham Forest","E09000031","Urban major conurbation",258249,256615,1634,0
"2011","Waltham Forest","E09000031","Urban minor conurbation",0,0,0,0
"2011","Waltham Forest","E09000031","Urban city and town",0,0,0,0
"2011","Waltham Forest","E09000031","Urban city and town in a sparse setting",0,0,0,0
"2011","Waltham Forest","E09000031","Rural (total)",0,0,0,0
"2011","Waltham Forest","E09000031","Rural town and fringe",0,0,0,0
"2011","Waltham Forest","E09000031","Rural town and fringe in a sparse setting",0,0,0,0
"2011","Waltham Forest","E09000031","Rural village",0,0,0,0
"2011","Waltham Forest","E09000031","Rural village in a sparse setting",0,0,0,0
"2011","Waltham Forest","E09000031","Rural hamlet and isolated dwellings",0,0,0,0
"2011","Waltham Forest","E09000031","Rural hamlet and isolated dwellings in a sparse setting",0,0,0,0
"2011","Bracknell Forest","E06000036","Total",113205,110512,2693,0
"2011","Bracknell Forest","E06000036","Urban (total)",110896,108206,2690,0
"2011","Bracknell Forest","E06000036","Urban major conurbation",0,0,0,0
"2011","Bracknell Forest","E06000036","Urban minor conurbation",0,0,0,0
"2011","Bracknell Forest","E06000036","Urban city and town",110896,108206,2690,0
"2011","Bracknell Forest","E06000036","Urban city and town in a sparse setting",0,0,0,0
"2011","Bracknell Forest","E06000036","Rural (total)",2309,2306,3,0
"2011","Bracknell Forest","E06000036","Rural town and fringe",106,106,0,0
"2011","Bracknell Forest","E06000036","Rural town and fringe in a sparse setting",0,0,0,0
"2011","Bracknell Forest","E06000036","Rural village",1089,1089,0,0
"2011","Bracknell Forest","E06000036","Rural village in a sparse setting",0,0,0,0
"2011","Bracknell Forest","E06000036","Rural hamlet and isolated dwellings",1114,1111,3,0
"2011","Bracknell Forest","E06000036","Rural hamlet and isolated dwellings in a sparse setting",0,0,0,0
"2011","Brighton and Hove","E06000043","Total",273369,266059,7310,1
"2011","Brighton and Hove","E06000043","Urban (total)",269051,265203,3848,1
"2011","Brighton and Hove","E06000043","Urban major conurbation",0,0,0,0
"2011","Brighton and Hove","E06000043","Urban minor conurbation",0,0,0,0
"2011","Brighton and Hove","E06000043","Urban city and town",269051,265203,3848,1
"2011","Brighton and Hove","E06000043","Urban city and town in a sparse setting",0,0,0,0
"2011","Brighton and Hove","E06000043","Rural (total)",4318,856,3462,0
"2011","Brighton and Hove","E06000043","Rural town and fringe",1004,361,643,0
"2011","Brighton and Hove","E06000043","Rural town and fringe in a sparse setting",0,0,0,0
"2011","Brighton and Hove","E06000043","Rural village",0,0,0,0
"2011","Brighton and Hove","E06000043","Rural village in a sparse setting",0,0,0,0
"2011","Brighton and Hove","E06000043","Rural hamlet and isolated dwellings",3314,495,2819,0
"2011","Brighton and Hove","E06000043","Rural hamlet and isolated dwellings in a sparse setting",0,0,0,0
"2011","Isle of Wight","E06000046","Total",138265,133713,4552,1
"2011","Isle of Wight","E06000046","Urban (total)",93566,90004,3562,0
"2011","Isle of Wight","E06000046","Urban major conurbation",0,0,0,0
"2011","Isle of Wight","E06000046","Urban minor conurbation",0,0,0,0
"2011","Isle of Wight","E06000046","Urban city and town",93566,90004,3562,0
"2011","Isle of Wight","E06000046","Urban city and town in a sparse setting",0,0,0,0
"2011","Isle of Wight","E06000046","Rural (total)",44699,43709,990,1
"2011","Isle of Wight","E06000046","Rural town and fringe",26689,25998,691,0
"2011","Isle of Wight","E06000046","Rural town and fringe in a sparse setting",0,0,0,0
"2011","Isle of Wight","E06000046","Rural village",10008,9905,103,1
"2011","Isle of Wight","E06000046","Rural village in a sparse setting",0,0,0,0
"2011","Isle of Wight","E06000046","Rural hamlet and isolated dwellings",8002,7806,196,0
"2011","Isle of Wight","E06000046","Rural hamlet and isolated dwellings in a sparse setting",0,0,0,0
"2011","Medway","E06000035","Total",263925,259988,3937,0
"2011","Medway","E06000035","Urban (total)",235468,231631,3837,0
"2011","Medway","E06000035","Urban major conurbation",0,0,0,0
"2011","Medway","E06000035","Urban minor conurbation",0,0,0,0
"2011","Medway","E06000035","Urban city and town",235468,231631,3837,0
"2011","Medway","E06000035","Urban city and town in a sparse setting",0,0,0,0
"2011","Medway","E06000035","Rural (total)",28457,28357,100,0
"2011","Medway","E06000035","Rural town and fringe",20741,20719,22,0
"2011","Medway","E06000035","Rural town and fringe in a sparse setting",0,0,0,0
"2011","Medway","E06000035","Rural village",4811,4787,24,0
"2011","Medway","E06000035","Rural village in a sparse setting",0,0,0,0
"2011","Medway","E06000035","Rural hamlet and isolated dwellings",2905,2851,54,0
"2011","Medway","E06000035","Rural hamlet and isolated dwellings in a sparse setting",0,0,0,0
"2011","Milton Keynes","E06000042","Total",248821,246715,2106,0
"2011","Milton Keynes","E06000042","Urban (total)",227168,225216,1952,0
"2011","Milton Keynes","E06000042","Urban major conurbation",0,0,0,0
"2011","Milton Keynes","E06000042","Urban minor conurbation",0,0,0,0
"2011","Milton Keynes","E06000042","Urban city and town",227168,225216,1952,0
"2011","Milton Keynes","E06000042","Urban city and town in a sparse setting",0,0,0,0
"2011","Milton Keynes","E06000042","Rural (total)",21653,21499,154,0
"2011","Milton Keynes","E06000042","Rural town and fringe",11712,11606,106,0
"2011","Milton Keynes","E06000042","Rural town and fringe in a sparse setting",0,0,0,0
"2011","Milton Keynes","E06000042","Rural village",8683,8636,47,0
"2011","Milton Keynes","E06000042","Rural village in a sparse setting",0,0,0,0
"2011","Milton Keynes","E06000042","Rural hamlet and isolated dwellings",1258,1257,1,0
"2011","Milton Keynes","E06000042","Rural hamlet and isolated dwellings in a sparse setting",0,0,0,0
"2011","Portsmouth","E06000044","Total",205056,200052,5004,4
"2011","Portsmouth","E06000044","Urban (total)",205056,200052,5004,4
"2011","Portsmouth","E06000044","Urban major conurbation",0,0,0,0
"2011","Portsmouth","E06000044","Urban minor conurbation",0,0,0,0
"2011","Portsmouth","E06000044","Urban city and town",205056,200052,5004,4
"2011","Portsmouth","E06000044","Urban city and town in a sparse setting",0,0,0,0
"2011","Portsmouth","E06000044","Rural (total)",0,0,0,0
"2011","Portsmouth","E06000044","Rural town and fringe",0,0,0,0
"2011","Portsmouth","E06000044","Rural town and fringe in a sparse setting",0,0,0,0
"2011","Portsmouth","E06000044","Rural village",0,0,0,0
"2011","Portsmouth","E06000044","Rural village in a sparse setting",0,0,0,0
"2011","Portsmouth","E06000044","Rural hamlet and isolated dwellings",0,0,0,0
"2011","Portsmouth","E06000044","Rural hamlet and isolated dwellings in a sparse setting",0,0,0,0
"2011","Reading","E06000038","Total",155698,151330,4368,0
"2011","Reading","E06000038","Urban (total)",155230,150862,4368,0
"2011","Reading","E06000038","Urban major conurbation",0,0,0,0
"2011","Reading","E06000038","Urban minor conurbation",0,0,0,0
"2011","Reading","E06000038","Urban city and town",155230,150862,4368,0
"2011","Reading","E06000038","Urban city and town in a sparse setting",0,0,0,0
"2011","Reading","E06000038","Rural (total)",468,468,0,0
"2011","Reading","E06000038","Rural town and fringe",468,468,0,0
"2011","Reading","E06000038","Rural town and fringe in a sparse setting",0,0,0,0
"2011","Reading","E06000038","Rural village",0,0,0,0
"2011","Reading","E06000038","Rural village in a sparse setting",0,0,0,0
"2011","Reading","E06000038","Rural hamlet and isolated dwellings",0,0,0,0
"2011","Reading","E06000038","Rural hamlet and isolated dwellings in a sparse setting",0,0,0,0
"2011","Slough","E06000039","Total",140205,139697,508,0
"2011","Slough","E06000039","Urban (total)",140205,139697,508,0
"2011","Slough","E06000039","Urban major conurbation",0,0,0,0
"2011","Slough","E06000039","Urban minor conurbation",0,0,0,0
"2011","Slough","E06000039","Urban city and town",140205,139697,508,0
"2011","Slough","E06000039","Urban city and town in a sparse setting",0,0,0,0
"2011","Slough","E06000039","Rural (total)",0,0,0,0
"2011","Slough","E06000039","Rural town and fringe",0,0,0,0
"2011","Slough","E06000039","Rural town and fringe in a sparse setting",0,0,0,0
"2011","Slough","E06000039","Rural village",0,0,0,0
"2011","Slough","E06000039","Rural village in a sparse setting",0,0,0,0
"2011","Slough","E06000039","Rural hamlet and isolated dwellings",0,0,0,0
"2011","Slough","E06000039","Rural hamlet and isolated dwellings in a sparse setting",0,0,0,0
"2011","Southampton","E06000045","Total",236882,228459,8423,2
"2011","Southampton","E06000045","Urban (total)",236882,228459,8423,2
"2011","Southampton","E06000045","Urban major conurbation",0,0,0,0
"2011","Southampton","E06000045","Urban minor conurbation",0,0,0,0
"2011","Southampton","E06000045","Urban city and town",236882,228459,8423,2
"2011","Southampton","E06000045","Urban city and town in a sparse setting",0,0,0,0
"2011","Southampton","E06000045","Rural (total)",0,0,0,0
"2011","Southampton","E06000045","Rural town and fringe",0,0,0,0
"2011","Southampton","E06000045","Rural town and fringe in a sparse setting",0,0,0,0
"2011","Southampton","E06000045","Rural village",0,0,0,0
"2011","Southampton","E06000045","Rural village in a sparse setting",0,0,0,0
"2011","Southampton","E06000045","Rural hamlet and isolated dwellings",0,0,0,0
"2011","Southampton","E06000045","Rural hamlet and isolated dwellings in a sparse setting",0,0,0,0
"2011","West Berkshire","E06000037","Total",153822,150878,2944,0
"2011","West Berkshire","E06000037","Urban (total)",96873,95713,1160,0
"2011","West Berkshire","E06000037","Urban major conurbation",0,0,0,0
"2011","West Berkshire","E06000037","Urban minor conurbation",0,0,0,0
"2011","West Berkshire","E06000037","Urban city and town",96873,95713,1160,0
"2011","West Berkshire","E06000037","Urban city and town in a sparse setting",0,0,0,0
"2011","West Berkshire","E06000037","Rural (total)",56949,55165,1784,0
"2011","West Berkshire","E06000037","Rural town and fringe",23776,23634,142,0
"2011","West Berkshire","E06000037","Rural town and fringe in a sparse setting",0,0,0,0
"2011","West Berkshire","E06000037","Rural village",19513,18589,924,0
"2011","West Berkshire","E06000037","Rural village in a sparse setting",0,0,0,0
"2011","West Berkshire","E06000037","Rural hamlet and isolated dwellings",13660,12942,718,0
"2011","West Berkshire","E06000037","Rural hamlet and isolated dwellings in a sparse setting",0,0,0,0
"2011","Windsor and Maidenhead","E06000040","Total",144560,141065,3495,1
"2011","Windsor and Maidenhead","E06000040","Urban (total)",129599,126256,3343,1
"2011","Windsor and Maidenhead","E06000040","Urban major conurbation",389,389,0,0
"2011","Windsor and Maidenhead","E06000040","Urban minor conurbation",0,0,0,0
"2011","Windsor and Maidenhead","E06000040","Urban city and town",129210,125867,3343,1
"2011","Windsor and Maidenhead","E06000040","Urban city and town in a sparse setting",0,0,0,0
"2011","Windsor and Maidenhead","E06000040","Rural (total)",14961,14809,152,0
"2011","Windsor and Maidenhead","E06000040","Rural town and fringe",6849,6785,64,0
"2011","Windsor and Maidenhead","E06000040","Rural town and fringe in a sparse setting",0,0,0,0
"2011","Windsor and Maidenhead","E06000040","Rural village",6153,6086,67,0
"2011","Windsor and Maidenhead","E06000040","Rural village in a sparse setting",0,0,0,0
"2011","Windsor and Maidenhead","E06000040","Rural hamlet and isolated dwellings",1959,1938,21,0
"2011","Windsor and Maidenhead","E06000040","Rural hamlet and isolated dwellings in a sparse setting",0,0,0,0
"2011","Wokingham","E06000041","Total",154380,151740,2640,0
"2011","Wokingham","E06000041","Urban (total)",127335,125341,1994,0
"2011","Wokingham","E06000041","Urban major conurbation",0,0,0,0
"2011","Wokingham","E06000041","Urban minor conurbation",0,0,0,0
"2011","Wokingham","E06000041","Urban city and town",127335,125341,1994,0
"2011","Wokingham","E06000041","Urban city and town in a sparse setting",0,0,0,0
"2011","Wokingham","E06000041","Rural (total)",27045,26399,646,0
"2011","Wokingham","E06000041","Rural town and fringe",16218,16107,111,0
"2011","Wokingham","E06000041","Rural town and fringe in a sparse setting",0,0,0,0
"2011","Wokingham","E06000041","Rural village",5226,5182,44,0
"2011","Wokingham","E06000041","Rural village in a sparse setting",0,0,0,0
"2011","Wokingham","E06000041","Rural hamlet and isolated dwellings",5601,5110,491,0
"2011","Wokingham","E06000041","Rural hamlet and isolated dwellings in a sparse setting",0,0,0,0
"2011","Buckinghamshire","E10000002","Total",505283,497299,7984,1
"2011","Buckinghamshire","E10000002","Urban (total)",339543,334508,5035,1
"2011","Buckinghamshire","E10000002","Urban major conurbation",1446,1446,0,0
"2011","Buckinghamshire","E10000002","Urban minor conurbation",0,0,0,0
"2011","Buckinghamshire","E10000002","Urban city and town",338097,333062,5035,1
"2011","Buckinghamshire","E10000002","Urban city and town in a sparse setting",0,0,0,0
"2011","Buckinghamshire","E10000002","Rural (total)",165740,162791,2949,0
"2011","Buckinghamshire","E10000002","Rural town and fringe",82743,82139,604,0
"2011","Buckinghamshire","E10000002","Rural town and fringe in a sparse setting",0,0,0,0
"2011","Buckinghamshire","E10000002","Rural village",55845,54879,966,0
"2011","Buckinghamshire","E10000002","Rural village in a sparse setting",0,0,0,0
"2011","Buckinghamshire","E10000002","Rural hamlet and isolated dwellings",27152,25773,1379,0
"2011","Buckinghamshire","E10000002","Rural hamlet and isolated dwellings in a sparse setting",0,0,0,0
"2011","East Sussex","E10000011","Total",526671,515598,11073,3
"2011","East Sussex","E10000011","Urban (total)",389946,382480,7466,3
"2011","East Sussex","E10000011","Urban major conurbation",0,0,0,0
"2011","East Sussex","E10000011","Urban minor conurbation",0,0,0,0
"2011","East Sussex","E10000011","Urban city and town",389946,382480,7466,3
"2011","East Sussex","E10000011","Urban city and town in a sparse setting",0,0,0,0
"2011","East Sussex","E10000011","Rural (total)",136725,133118,3607,0
"2011","East Sussex","E10000011","Rural town and fringe",48728,47866,862,0
"2011","East Sussex","E10000011","Rural town and fringe in a sparse setting",0,0,0,0
"2011","East Sussex","E10000011","Rural village",51147,49616,1531,0
"2011","East Sussex","E10000011","Rural village in a sparse setting",0,0,0,0
"2011","East Sussex","E10000011","Rural hamlet and isolated dwellings",36850,35636,1214,0
"2011","East Sussex","E10000011","Rural hamlet and isolated dwellings in a sparse setting",0,0,0,0
"2011","Hampshire","E10000014","Total",1317788,1296211,21577,10
"2011","Hampshire","E10000014","Urban (total)",1029336,1016394,12942,10
"2011","Hampshire","E10000014","Urban major conurbation",0,0,0,0
"2011","Hampshire","E10000014","Urban minor conurbation",0,0,0,0
"2011","Hampshire","E10000014","Urban city and town",1029336,1016394,12942,10
"2011","Hampshire","E10000014","Urban city and town in a sparse setting",0,0,0,0
"2011","Hampshire","E10000014","Rural (total)",288452,279817,8635,0
"2011","Hampshire","E10000014","Rural town and fringe",140624,137523,3101,0
"2011","Hampshire","E10000014","Rural town and fringe in a sparse setting",0,0,0,0
"2011","Hampshire","E10000014","Rural village",84029,81074,2955,0
"2011","Hampshire","E10000014","Rural village in a sparse setting",0,0,0,0
"2011","Hampshire","E10000014","Rural hamlet and isolated dwellings",63799,61220,2579,0
"2011","Hampshire","E10000014","Rural hamlet and isolated dwellings in a sparse setting",0,0,0,0
"2011","Kent","E10000016","Total",1463740,1435745,27995,4
"2011","Kent","E10000016","Urban (total)",1058640,1038145,20495,4
"2011","Kent","E10000016","Urban major conurbation",183535,182236,1299,1
"2011","Kent","E10000016","Urban minor conurbation",0,0,0,0
"2011","Kent","E10000016","Urban city and town",875105,855909,19196,3
"2011","Kent","E10000016","Urban city and town in a sparse setting",0,0,0,0
"2011","Kent","E10000016","Rural (total)",405100,397600,7500,0
"2011","Kent","E10000016","Rural town and fringe",203648,201316,2332,0
"2011","Kent","E10000016","Rural town and fringe in a sparse setting",0,0,0,0
"2011","Kent","E10000016","Rural village",117361,114518,2843,0
"2011","Kent","E10000016","Rural village in a sparse setting",0,0,0,0
"2011","Kent","E10000016","Rural hamlet and isolated dwellings",84091,81766,2325,0
"2011","Kent","E10000016","Rural hamlet and isolated dwellings in a sparse setting",0,0,0,0
"2011","Oxfordshire","E10000025","Total",653798,624099,29699,3
"2011","Oxfordshire","E10000025","Urban (total)",435201,412291,22910,3
"2011","Oxfordshire","E10000025","Urban major conurbation",0,0,0,0
"2011","Oxfordshire","E10000025","Urban minor conurbation",0,0,0,0
"2011","Oxfordshire","E10000025","Urban city and town",435201,412291,22910,3
"2011","Oxfordshire","E10000025","Urban city and town in a sparse setting",0,0,0,0
"2011","Oxfordshire","E10000025","Rural (total)",218597,211808,6789,0
"2011","Oxfordshire","E10000025","Rural town and fringe",101280,98743,2537,0
"2011","Oxfordshire","E10000025","Rural town and fringe in a sparse setting",0,0,0,0
"2011","Oxfordshire","E10000025","Rural village",91571,89276,2295,0
"2011","Oxfordshire","E10000025","Rural village in a sparse setting",0,0,0,0
"2011","Oxfordshire","E10000025","Rural hamlet and isolated dwellings",25746,23789,1957,0
"2011","Oxfordshire","E10000025","Rural hamlet and isolated dwellings in a sparse setting",0,0,0,0
"2011","Surrey","E10000030","Total",1132390,1105800,26590,3
"2011","Surrey","E10000030","Urban (total)",980249,958798,21451,2
"2011","Surrey","E10000030","Urban major conurbation",551737,542290,9447,1
"2011","Surrey","E10000030","Urban minor conurbation",0,0,0,0
"2011","Surrey","E10000030","Urban city and town",428512,416508,12004,1
"2011","Surrey","E10000030","Urban city and town in a sparse setting",0,0,0,0
"2011","Surrey","E10000030","Rural (total)",152141,147002,5139,1
"2011","Surrey","E10000030","Rural town and fringe",64916,63705,1211,0
"2011","Surrey","E10000030","Rural town and fringe in a sparse setting",0,0,0,0
"2011","Surrey","E10000030","Rural village",47629,46194,1435,0
"2011","Surrey","E10000030","Rural village in a sparse setting",0,0,0,0
"2011","Surrey","E10000030","Rural hamlet and isolated dwellings",39596,37103,2493,1
"2011","Surrey","E10000030","Rural hamlet and isolated dwellings in a sparse setting",0,0,0,0
"2011","West Sussex","E10000032","Total",806892,791540,15352,4
"2011","West Sussex","E10000032","Urban (total)",615318,606209,9109,3
"2011","West Sussex","E10000032","Urban major conurbation",0,0,0,0
"2011","West Sussex","E10000032","Urban minor conurbation",0,0,0,0
"2011","West Sussex","E10000032","Urban city and town",615318,606209,9109,3
"2011","West Sussex","E10000032","Urban city and town in a sparse setting",0,0,0,0
"2011","West Sussex","E10000032","Rural (total)",191574,185331,6243,1
"2011","West Sussex","E10000032","Rural town and fringe",101262,100202,1060,1
"2011","West Sussex","E10000032","Rural town and fringe in a sparse setting",0,0,0,0
"2011","West Sussex","E10000032","Rural village",47936,45446,2490,0
"2011","West Sussex","E10000032","Rural village in a sparse setting",0,0,0,0
"2011","West Sussex","E10000032","Rural hamlet and isolated dwellings",42376,39683,2693,0
"2011","West Sussex","E10000032","Rural hamlet and isolated dwellings in a sparse setting",0,0,0,0
"2011","Bath and North East Somerset","E06000022","Total",176016,169977,6039,0
"2011","Bath and North East Somerset","E06000022","Urban (total)",138913,133879,5034,0
"2011","Bath and North East Somerset","E06000022","Urban major conurbation",0,0,0,0
"2011","Bath and North East Somerset","E06000022","Urban minor conurbation",0,0,0,0
"2011","Bath and North East Somerset","E06000022","Urban city and town",138913,133879,5034,0
"2011","Bath and North East Somerset","E06000022","Urban city and town in a sparse setting",0,0,0,0
"2011","Bath and North East Somerset","E06000022","Rural (total)",37103,36098,1005,0
"2011","Bath and North East Somerset","E06000022","Rural town and fringe",16057,15807,250,0
"2011","Bath and North East Somerset","E06000022","Rural town and fringe in a sparse setting",0,0,0,0
"2011","Bath and North East Somerset","E06000022","Rural village",16551,15843,708,0
"2011","Bath and North East Somerset","E06000022","Rural village in a sparse setting",0,0,0,0
"2011","Bath and North East Somerset","E06000022","Rural hamlet and isolated dwellings",4495,4448,47,0
"2011","Bath and North East Somerset","E06000022","Rural hamlet and isolated dwellings in a sparse setting",0,0,0,0
"2011","Bournemouth","E06000028","Total",183491,179138,4353,1
"2011","Bournemouth","E06000028","Urban (total)",183352,178999,4353,1
"2011","Bournemouth","E06000028","Urban major conurbation",0,0,0,0
"2011","Bournemouth","E06000028","Urban minor conurbation",0,0,0,0
"2011","Bournemouth","E06000028","Urban city and town",183352,178999,4353,1
"2011","Bournemouth","E06000028","Urban city and town in a sparse setting",0,0,0,0
"2011","Bournemouth","E06000028","Rural (total)",139,139,0,0
"2011","Bournemouth","E06000028","Rural town and fringe",0,0,0,0
"2011","Bournemouth","E06000028","Rural town and fringe in a sparse setting",0,0,0,0
"2011","Bournemouth","E06000028","Rural village",0,0,0,0
"2011","Bournemouth","E06000028","Rural village in a sparse setting",0,0,0,0
"2011","Bournemouth","E06000028","Rural hamlet and isolated dwellings",139,139,0,0
"2011","Bournemouth","E06000028","Rural hamlet and isolated dwellings in a sparse setting",0,0,0,0
"2011","Bristol, City of","E06000023","Total",428234,418814,9420,0
"2011","Bristol, City of","E06000023","Urban (total)",428234,418814,9420,0
"2011","Bristol, City of","E06000023","Urban major conurbation",0,0,0,0
"2011","Bristol, City of","E06000023","Urban minor conurbation",0,0,0,0
"2011","Bristol, City of","E06000023","Urban city and town",428234,418814,9420,0
"2011","Bristol, City of","E06000023","Urban city and town in a sparse setting",0,0,0,0
"2011","Bristol, City of","E06000023","Rural (total)",0,0,0,0
"2011","Bristol, City of","E06000023","Rural town and fringe",0,0,0,0
"2011","Bristol, City of","E06000023","Rural town and fringe in a sparse setting",0,0,0,0
"2011","Bristol, City of","E06000023","Rural village",0,0,0,0
"2011","Bristol, City of","E06000023","Rural village in a sparse setting",0,0,0,0
"2011","Bristol, City of","E06000023","Rural hamlet and isolated dwellings",0,0,0,0
"2011","Bristol, City of","E06000023","Rural hamlet and isolated dwellings in a sparse setting",0,0,0,0
"2011","Cornwall","E06000052","Total",532273,523432,8841,6
"2011","Cornwall","E06000052","Urban (total)",205591,201302,4289,4
"2011","Cornwall","E06000052","Urban major conurbation",0,0,0,0
"2011","Cornwall","E06000052","Urban minor conurbation",0,0,0,0
"2011","Cornwall","E06000052","Urban city and town",205591,201302,4289,4
"2011","Cornwall","E06000052","Urban city and town in a sparse setting",0,0,0,0
"2011","Cornwall","E06000052","Rural (total)",326682,322130,4552,2
"2011","Cornwall","E06000052","Rural town and fringe",120849,119560,1289,0
"2011","Cornwall","E06000052","Rural town and fringe in a sparse setting",25211,24689,522,1
"2011","Cornwall","E06000052","Rural village",81684,80695,989,0
"2011","Cornwall","E06000052","Rural village in a sparse setting",19889,19291,598,0
"2011","Cornwall","E06000052","Rural hamlet and isolated dwellings",65004,64203,801,0
"2011","Cornwall","E06000052","Rural hamlet and isolated dwellings in a sparse setting",14045,13692,353,1
"2011","Isles of Scilly","E06000053","Total",2203,2123,80,0
"2011","Isles of Scilly","E06000053","Urban (total)",0,0,0,0
"2011","Isles of Scilly","E06000053","Urban major conurbation",0,0,0,0
"2011","Isles of Scilly","E06000053","Urban minor conurbation",0,0,0,0
"2011","Isles of Scilly","E06000053","Urban city and town",0,0,0,0
"2011","Isles of Scilly","E06000053","Urban city and town in a sparse setting",0,0,0,0
"2011","Isles of Scilly","E06000053","Rural (total)",2203,2123,80,0
"2011","Isles of Scilly","E06000053","Rural town and fringe",0,0,0,0
"2011","Isles of Scilly","E06000053","Rural town and fringe in a sparse setting",0,0,0,0
"2011","Isles of Scilly","E06000053","Rural village",0,0,0,0
"2011","Isles of Scilly","E06000053","Rural village in a sparse setting",2067,1990,77,0
"2011","Isles of Scilly","E06000053","Rural hamlet and isolated dwellings",0,0,0,0
"2011","Isles of Scilly","E06000053","Rural hamlet and isolated dwellings in a sparse setting",136,133,3,0
"2011","North Somerset","E06000024","Total",202566,199225,3341,1
"2011","North Somerset","E06000024","Urban (total)",165328,162464,2864,1
"2011","North Somerset","E06000024","Urban major conurbation",0,0,0,0
"2011","North Somerset","E06000024","Urban minor conurbation",0,0,0,0
"2011","North Somerset","E06000024","Urban city and town",165328,162464,2864,1
"2011","North Somerset","E06000024","Urban city and town in a sparse setting",0,0,0,0
"2011","North Somerset","E06000024","Rural (total)",37238,36761,477,0
"2011","North Somerset","E06000024","Rural town and fringe",13494,13458,36,0
"2011","North Somerset","E06000024","Rural town and fringe in a sparse setting",0,0,0,0
"2011","North Somerset","E06000024","Rural village",15563,15356,207,0
"2011","North Somerset","E06000024","Rural village in a sparse setting",0,0,0,0
"2011","North Somerset","E06000024","Rural hamlet and isolated dwellings",8181,7947,234,0
"2011","North Somerset","E06000024","Rural hamlet and isolated dwellings in a sparse setting",0,0,0,0
"2011","Plymouth","E06000026","Total",256384,251100,5284,2
"2011","Plymouth","E06000026","Urban (total)",256384,251100,5284,2
"2011","Plymouth","E06000026","Urban major conurbation",0,0,0,0
"2011","Plymouth","E06000026","Urban minor conurbation",0,0,0,0
"2011","Plymouth","E06000026","Urban city and town",256384,251100,5284,2
"2011","Plymouth","E06000026","Urban city and town in a sparse setting",0,0,0,0
"2011","Plymouth","E06000026","Rural (total)",0,0,0,0
"2011","Plymouth","E06000026","Rural town and fringe",0,0,0,0
"2011","Plymouth","E06000026","Rural town and fringe in a sparse setting",0,0,0,0
"2011","Plymouth","E06000026","Rural village",0,0,0,0
"2011","Plymouth","E06000026","Rural village in a sparse setting",0,0,0,0
"2011","Plymouth","E06000026","Rural hamlet and isolated dwellings",0,0,0,0
"2011","Plymouth","E06000026","Rural hamlet and isolated dwellings in a sparse setting",0,0,0,0
"2011","Poole","E06000029","Total",147645,145103,2542,1
"2011","Poole","E06000029","Urban (total)",147409,144867,2542,1
"2011","Poole","E06000029","Urban major conurbation",0,0,0,0
"2011","Poole","E06000029","Urban minor conurbation",0,0,0,0
"2011","Poole","E06000029","Urban city and town",147409,144867,2542,1
"2011","Poole","E06000029","Urban city and town in a sparse setting",0,0,0,0
"2011","Poole","E06000029","Rural (total)",236,236,0,0
"2011","Poole","E06000029","Rural town and fringe",0,0,0,0
"2011","Poole","E06000029","Rural town and fringe in a sparse setting",0,0,0,0
"2011","Poole","E06000029","Rural village",0,0,0,0
"2011","Poole","E06000029","Rural village in a sparse setting",0,0,0,0
"2011","Poole","E06000029","Rural hamlet and isolated dwellings",236,236,0,0
"2011","Poole","E06000029","Rural hamlet and isolated dwellings in a sparse setting",0,0,0,0
"2011","South Gloucestershire","E06000025","Total",262767,258207,4560,0
"2011","South Gloucestershire","E06000025","Urban (total)",228404,224904,3500,0
"2011","South Gloucestershire","E06000025","Urban major conurbation",0,0,0,0
"2011","South Gloucestershire","E06000025","Urban minor conurbation",0,0,0,0
"2011","South Gloucestershire","E06000025","Urban city and town",228404,224904,3500,0
"2011","South Gloucestershire","E06000025","Urban city and town in a sparse setting",0,0,0,0
"2011","South Gloucestershire","E06000025","Rural (total)",34363,33303,1060,0
"2011","South Gloucestershire","E06000025","Rural town and fringe",13612,13416,196,0
"2011","South Gloucestershire","E06000025","Rural town and fringe in a sparse setting",0,0,0,0
"2011","South Gloucestershire","E06000025","Rural village",12117,11811,306,0
"2011","South Gloucestershire","E06000025","Rural village in a sparse setting",0,0,0,0
"2011","South Gloucestershire","E06000025","Rural hamlet and isolated dwellings",8634,8076,558,0
"2011","South Gloucestershire","E06000025","Rural hamlet and isolated dwellings in a sparse setting",0,0,0,0
"2011","Swindon","E06000030","Total",209156,207858,1298,0
"2011","Swindon","E06000030","Urban (total)",185308,184352,956,0
"2011","Swindon","E06000030","Urban major conurbation",0,0,0,0
"2011","Swindon","E06000030","Urban minor conurbation",0,0,0,0
"2011","Swindon","E06000030","Urban city and town",185308,184352,956,0
"2011","Swindon","E06000030","Urban city and town in a sparse setting",0,0,0,0
"2011","Swindon","E06000030","Rural (total)",23848,23506,342,0
"2011","Swindon","E06000030","Rural town and fringe",18927,18764,163,0
"2011","Swindon","E06000030","Rural town and fringe in a sparse setting",0,0,0,0
"2011","Swindon","E06000030","Rural village",3385,3251,134,0
"2011","Swindon","E06000030","Rural village in a sparse setting",0,0,0,0
"2011","Swindon","E06000030","Rural hamlet and isolated dwellings",1536,1491,45,0
"2011","Swindon","E06000030","Rural hamlet and isolated dwellings in a sparse setting",0,0,0,0
"2011","Torbay","E06000027","Total",130959,127908,3051,0
"2011","Torbay","E06000027","Urban (total)",130197,127146,3051,0
"2011","Torbay","E06000027","Urban major conurbation",0,0,0,0
"2011","Torbay","E06000027","Urban minor conurbation",0,0,0,0
"2011","Torbay","E06000027","Urban city and town",130197,127146,3051,0
"2011","Torbay","E06000027","Urban city and town in a sparse setting",0,0,0,0
"2011","Torbay","E06000027","Rural (total)",762,762,0,0
"2011","Torbay","E06000027","Rural town and fringe",0,0,0,0
"2011","Torbay","E06000027","Rural town and fringe in a sparse setting",0,0,0,0
"2011","Torbay","E06000027","Rural village",460,460,0,0
"2011","Torbay","E06000027","Rural village in a sparse setting",0,0,0,0
"2011","Torbay","E06000027","Rural hamlet and isolated dwellings",302,302,0,0
"2011","Torbay","E06000027","Rural hamlet and isolated dwellings in a sparse setting",0,0,0,0
"2011","Wiltshire","E06000054","Total",470981,457954,13027,2
"2011","Wiltshire","E06000054","Urban (total)",247262,243773,3489,2
"2011","Wiltshire","E06000054","Urban major conurbation",0,0,0,0
"2011","Wiltshire","E06000054","Urban minor conurbation",0,0,0,0
"2011","Wiltshire","E06000054","Urban city and town",247262,243773,3489,2
"2011","Wiltshire","E06000054","Urban city and town in a sparse setting",0,0,0,0
"2011","Wiltshire","E06000054","Rural (total)",223719,214181,9538,0
"2011","Wiltshire","E06000054","Rural town and fringe",87894,84593,3301,0
"2011","Wiltshire","E06000054","Rural town and fringe in a sparse setting",0,0,0,0
"2011","Wiltshire","E06000054","Rural village",95036,91324,3712,0
"2011","Wiltshire","E06000054","Rural village in a sparse setting",0,0,0,0
"2011","Wiltshire","E06000054","Rural hamlet and isolated dwellings",40789,38264,2525,0
"2011","Wiltshire","E06000054","Rural hamlet and isolated dwellings in a sparse setting",0,0,0,0
"2011","Devon","E10000008","Total",746399,727737,18662,4
"2011","Devon","E10000008","Urban (total)",362368,351989,10379,3
"2011","Devon","E10000008","Urban major conurbation",0,0,0,0
"2011","Devon","E10000008","Urban minor conurbation",0,0,0,0
"2011","Devon","E10000008","Urban city and town",351184,341205,9979,3
"2011","Devon","E10000008","Urban city and town in a sparse setting",11184,10784,400,0
"2011","Devon","E10000008","Rural (total)",384031,375748,8283,1
"2011","Devon","E10000008","Rural town and fringe",155391,153117,2274,1
"2011","Devon","E10000008","Rural town and fringe in a sparse setting",25417,24863,554,0
"2011","Devon","E10000008","Rural village",78456,76644,1812,0
"2011","Devon","E10000008","Rural village in a sparse setting",16886,16787,99,0
"2011","Devon","E10000008","Rural hamlet and isolated dwellings",79990,77008,2982,0
"2011","Devon","E10000008","Rural hamlet and isolated dwellings in a sparse setting",27891,27329,562,0
"2011","Dorset","E10000009","Total",412905,403366,9539,0
"2011","Dorset","E10000009","Urban (total)",244328,241208,3120,0
"2011","Dorset","E10000009","Urban major conurbation",0,0,0,0
"2011","Dorset","E10000009","Urban minor conurbation",0,0,0,0
"2011","Dorset","E10000009","Urban city and town",244328,241208,3120,0
"2011","Dorset","E10000009","Urban city and town in a sparse setting",0,0,0,0
"2011","Dorset","E10000009","Rural (total)",168577,162158,6419,0
"2011","Dorset","E10000009","Rural town and fringe",72615,70314,2301,0
"2011","Dorset","E10000009","Rural town and fringe in a sparse setting",274,245,29,0
"2011","Dorset","E10000009","Rural village",63362,61023,2339,0
"2011","Dorset","E10000009","Rural village in a sparse setting",0,0,0,0
"2011","Dorset","E10000009","Rural hamlet and isolated dwellings",32326,30576,1750,0
"2011","Dorset","E10000009","Rural hamlet and isolated dwellings in a sparse setting",0,0,0,0
"2011","Gloucestershire","E10000013","Total",596984,586018,10966,1
"2011","Gloucestershire","E10000013","Urban (total)",419967,412580,7387,0
"2011","Gloucestershire","E10000013","Urban major conurbation",0,0,0,0
"2011","Gloucestershire","E10000013","Urban minor conurbation",0,0,0,0
"2011","Gloucestershire","E10000013","Urban city and town",419967,412580,7387,0
"2011","Gloucestershire","E10000013","Urban city and town in a sparse setting",0,0,0,0
"2011","Gloucestershire","E10000013","Rural (total)",177017,173438,3579,1
"2011","Gloucestershire","E10000013","Rural town and fringe",68772,68131,641,0
"2011","Gloucestershire","E10000013","Rural town and fringe in a sparse setting",0,0,0,0
"2011","Gloucestershire","E10000013","Rural village",69212,68275,937,1
"2011","Gloucestershire","E10000013","Rural village in a sparse setting",0,0,0,0
"2011","Gloucestershire","E10000013","Rural hamlet and isolated dwellings",39033,37032,2001,0
"2011","Gloucestershire","E10000013","Rural hamlet and isolated dwellings in a sparse setting",0,0,0,0
"2011","Somerset","E10000027","Total",529972,517124,12848,1
"2011","Somerset","E10000027","Urban (total)",274709,267734,6975,1
"2011","Somerset","E10000027","Urban major conurbation",0,0,0,0
"2011","Somerset","E10000027","Urban minor conurbation",0,0,0,0
"2011","Somerset","E10000027","Urban city and town",262728,256900,5828,1
"2011","Somerset","E10000027","Urban city and town in a sparse setting",11981,10834,1147,0
"2011","Somerset","E10000027","Rural (total)",255263,249390,5873,0
"2011","Somerset","E10000027","Rural town and fringe",99111,97712,1399,0
"2011","Somerset","E10000027","Rural town and fringe in a sparse setting",2069,2026,43,0
"2011","Somerset","E10000027","Rural village",90644,88194,2450,0
"2011","Somerset","E10000027","Rural village in a sparse setting",2346,2326,20,0
"2011","Somerset","E10000027","Rural hamlet and isolated dwellings",56432,54539,1893,0
"2011","Somerset","E10000027","Rural hamlet and isolated dwellings in a sparse setting",4661,4593,68,0
"2011","Anglesey","W06000001","Total",69751,68941,810,0
"2011","Anglesey","W06000001","Urban (total)",11431,11361,70,0
"2011","Anglesey","W06000001","Urban major conurbation",0,0,0,0
"2011","Anglesey","W06000001","Urban minor conurbation",0,0,0,0
"2011","Anglesey","W06000001","Urban city and town",0,0,0,0
"2011","Anglesey","W06000001","Urban city and town in a sparse setting",11431,11361,70,0
"2011","Anglesey","W06000001","Rural (total)",58320,57580,740,0
"2011","Anglesey","W06000001","Rural town and fringe",11802,11635,167,0
"2011","Anglesey","W06000001","Rural town and fringe in a sparse setting",12277,12168,109,0
"2011","Anglesey","W06000001","Rural village",8420,8266,154,0
"2011","Anglesey","W06000001","Rural village in a sparse setting",15329,15071,258,0
"2011","Anglesey","W06000001","Rural hamlet and isolated dwellings",2744,2720,24,0
"2011","Anglesey","W06000001","Rural hamlet and isolated dwellings in a sparse setting",7748,7720,28,0
"2011","Gwynedd","W06000002","Total",121874,117974,3900,0
"2011","Gwynedd","W06000002","Urban (total)",17988,15288,2700,0
"2011","Gwynedd","W06000002","Urban major conurbation",0,0,0,0
"2011","Gwynedd","W06000002","Urban minor conurbation",0,0,0,0
"2011","Gwynedd","W06000002","Urban city and town",17988,15288,2700,0
"2011","Gwynedd","W06000002","Urban city and town in a sparse setting",0,0,0,0
"2011","Gwynedd","W06000002","Rural (total)",103886,102686,1200,0
"2011","Gwynedd","W06000002","Rural town and fringe",20950,20759,191,0
"2011","Gwynedd","W06000002","Rural town and fringe in a sparse setting",26753,26280,473,0
"2011","Gwynedd","W06000002","Rural village",10480,10409,71,0
"2011","Gwynedd","W06000002","Rural village in a sparse setting",29585,29340,245,0
"2011","Gwynedd","W06000002","Rural hamlet and isolated dwellings",4311,4231,80,0
"2011","Gwynedd","W06000002","Rural hamlet and isolated dwellings in a sparse setting",11807,11667,140,0
"2011","Conwy","W06000003","Total",115228,112531,2697,6
"2011","Conwy","W06000003","Urban (total)",79469,77175,2294,1
"2011","Conwy","W06000003","Urban major conurbation",0,0,0,0
"2011","Conwy","W06000003","Urban minor conurbation",0,0,0,0
"2011","Conwy","W06000003","Urban city and town",79469,77175,2294,1
"2011","Conwy","W06000003","Urban city and town in a sparse setting",0,0,0,0
"2011","Conwy","W06000003","Rural (total)",35759,35356,403,5
"2011","Conwy","W06000003","Rural town and fringe",15083,14893,190,1
"2011","Conwy","W06000003","Rural town and fringe in a sparse setting",3323,3268,55,0
"2011","Conwy","W06000003","Rural village",6071,6063,8,0
"2011","Conwy","W06000003","Rural village in a sparse setting",2340,2337,3,0
"2011","Conwy","W06000003","Rural hamlet and isolated dwellings",5341,5294,47,0
"2011","Conwy","W06000003","Rural hamlet and isolated dwellings in a sparse setting",3601,3501,100,4
"2011","Denbighshire","W06000004","Total",93734,92483,1251,0
"2011","Denbighshire","W06000004","Urban (total)",46267,46098,169,0
"2011","Denbighshire","W06000004","Urban major conurbation",0,0,0,0
"2011","Denbighshire","W06000004","Urban minor conurbation",0,0,0,0
"2011","Denbighshire","W06000004","Urban city and town",46267,46098,169,0
"2011","Denbighshire","W06000004","Urban city and town in a sparse setting",0,0,0,0
"2011","Denbighshire","W06000004","Rural (total)",47467,46385,1082,0
"2011","Denbighshire","W06000004","Rural town and fringe",25623,25064,559,0
"2011","Denbighshire","W06000004","Rural town and fringe in a sparse setting",0,0,0,0
"2011","Denbighshire","W06000004","Rural village",11037,10677,360,0
"2011","Denbighshire","W06000004","Rural village in a sparse setting",2787,2775,12,0
"2011","Denbighshire","W06000004","Rural hamlet and isolated dwellings",8020,7869,151,0
"2011","Denbighshire","W06000004","Rural hamlet and isolated dwellings in a sparse setting",0,0,0,0
"2011","Flintshire","W06000005","Total",152506,151679,827,0
"2011","Flintshire","W06000005","Urban (total)",105208,104644,564,0
"2011","Flintshire","W06000005","Urban major conurbation",0,0,0,0
"2011","Flintshire","W06000005","Urban minor conurbation",0,0,0,0
"2011","Flintshire","W06000005","Urban city and town",105208,104644,564,0
"2011","Flintshire","W06000005","Urban city and town in a sparse setting",0,0,0,0
"2011","Flintshire","W06000005","Rural (total)",47298,47035,263,0
"2011","Flintshire","W06000005","Rural town and fringe",19730,19641,89,0
"2011","Flintshire","W06000005","Rural town and fringe in a sparse setting",0,0,0,0
"2011","Flintshire","W06000005","Rural village",21291,21168,123,0
"2011","Flintshire","W06000005","Rural village in a sparse setting",0,0,0,0
"2011","Flintshire","W06000005","Rural hamlet and isolated dwellings",6277,6226,51,0
"2011","Flintshire","W06000005","Rural hamlet and isolated dwellings in a sparse setting",0,0,0,0
"2011","Wrexham","W06000006","Total",134844,133244,1600,0
"2011","Wrexham","W06000006","Urban (total)",91054,90047,1007,0
"2011","Wrexham","W06000006","Urban major conurbation",0,0,0,0
"2011","Wrexham","W06000006","Urban minor conurbation",0,0,0,0
"2011","Wrexham","W06000006","Urban city and town",91054,90047,1007,0
"2011","Wrexham","W06000006","Urban city and town in a sparse setting",0,0,0,0
"2011","Wrexham","W06000006","Rural (total)",43790,43197,593,0
"2011","Wrexham","W06000006","Rural town and fringe",24963,24458,505,0
"2011","Wrexham","W06000006","Rural town and fringe in a sparse setting",0,0,0,0
"2011","Wrexham","W06000006","Rural village",10583,10548,35,0
"2011","Wrexham","W06000006","Rural village in a sparse setting",0,0,0,0
"2011","Wrexham","W06000006","Rural hamlet and isolated dwellings",7927,7876,51,0
"2011","Wrexham","W06000006","Rural hamlet and isolated dwellings in a sparse setting",317,315,2,0
"2011","Powys","W06000023","Total",132976,131047,1929,1
"2011","Powys","W06000023","Urban (total)",17911,17650,261,0
"2011","Powys","W06000023","Urban major conurbation",0,0,0,0
"2011","Powys","W06000023","Urban minor conurbation",0,0,0,0
"2011","Powys","W06000023","Urban city and town",6554,6424,130,0
"2011","Powys","W06000023","Urban city and town in a sparse setting",11357,11226,131,0
"2011","Powys","W06000023","Rural (total)",115065,113397,1668,1
"2011","Powys","W06000023","Rural town and fringe",2981,2929,52,1
"2011","Powys","W06000023","Rural town and fringe in a sparse setting",34025,33174,851,0
"2011","Powys","W06000023","Rural village",9821,9635,186,0
"2011","Powys","W06000023","Rural village in a sparse setting",30862,30658,204,0
"2011","Powys","W06000023","Rural hamlet and isolated dwellings",3781,3677,104,0
"2011","Powys","W06000023","Rural hamlet and isolated dwellings in a sparse setting",33595,33324,271,0
"2011","Ceredigion","W06000008","Total",75922,71444,4478,0
"2011","Ceredigion","W06000008","Urban (total)",18749,15258,3491,0
"2011","Ceredigion","W06000008","Urban major conurbation",0,0,0,0
"2011","Ceredigion","W06000008","Urban minor conurbation",0,0,0,0
"2011","Ceredigion","W06000008","Urban city and town",0,0,0,0
"2011","Ceredigion","W06000008","Urban city and town in a sparse setting",18749,15258,3491,0
"2011","Ceredigion","W06000008","Rural (total)",57173,56186,987,0
"2011","Ceredigion","W06000008","Rural town and fringe",0,0,0,0
"2011","Ceredigion","W06000008","Rural town and fringe in a sparse setting",11689,11071,618,0
"2011","Ceredigion","W06000008","Rural village",0,0,0,0
"2011","Ceredigion","W06000008","Rural village in a sparse setting",27644,27416,228,0
"2011","Ceredigion","W06000008","Rural hamlet and isolated dwellings",0,0,0,0
"2011","Ceredigion","W06000008","Rural hamlet and isolated dwellings in a sparse setting",17840,17699,141,0
"2011","Pembrokeshire","W06000009","Total",122439,120545,1894,0
"2011","Pembrokeshire","W06000009","Urban (total)",28178,28024,154,0
"2011","Pembrokeshire","W06000009","Urban major conurbation",0,0,0,0
"2011","Pembrokeshire","W06000009","Urban minor conurbation",0,0,0,0
"2011","Pembrokeshire","W06000009","Urban city and town",28178,28024,154,0
"2011","Pembrokeshire","W06000009","Urban city and town in a sparse setting",0,0,0,0
"2011","Pembrokeshire","W06000009","Rural (total)",94261,92521,1740,0
"2011","Pembrokeshire","W06000009","Rural town and fringe",21753,21471,282,0
"2011","Pembrokeshire","W06000009","Rural town and fringe in a sparse setting",17662,17334,328,0
"2011","Pembrokeshire","W06000009","Rural village",10684,10614,70,0
"2011","Pembrokeshire","W06000009","Rural village in a sparse setting",19278,19098,180,0
"2011","Pembrokeshire","W06000009","Rural hamlet and isolated dwellings",6334,6217,117,0
"2011","Pembrokeshire","W06000009","Rural hamlet and isolated dwellings in a sparse setting",18550,17787,763,0
"2011","Carmarthenshire","W06000010","Total",183777,181227,2550,0
"2011","Carmarthenshire","W06000010","Urban (total)",89154,87562,1592,0
"2011","Carmarthenshire","W06000010","Urban major conurbation",0,0,0,0
"2011","Carmarthenshire","W06000010","Urban minor conurbation",0,0,0,0
"2011","Carmarthenshire","W06000010","Urban city and town",73300,72371,929,0
"2011","Carmarthenshire","W06000010","Urban city and town in a sparse setting",15854,15191,663,0
"2011","Carmarthenshire","W06000010","Rural (total)",94623,93665,958,0
"2011","Carmarthenshire","W06000010","Rural town and fringe",24932,24781,151,0
"2011","Carmarthenshire","W06000010","Rural town and fringe in a sparse setting",4127,3904,223,0
"2011","Carmarthenshire","W06000010","Rural village",15378,15279,99,0
"2011","Carmarthenshire","W06000010","Rural village in a sparse setting",16545,16358,187,0
"2011","Carmarthenshire","W06000010","Rural hamlet and isolated dwellings",14502,14362,140,0
"2011","Carmarthenshire","W06000010","Rural hamlet and isolated dwellings in a sparse setting",19139,18981,158,0
"2011","Swansea","W06000011","Total",239023,234363,4660,1
"2011","Swansea","W06000011","Urban (total)",210418,206170,4248,1
"2011","Swansea","W06000011","Urban major conurbation",0,0,0,0
"2011","Swansea","W06000011","Urban minor conurbation",0,0,0,0
"2011","Swansea","W06000011","Urban city and town",210418,206170,4248,1
"2011","Swansea","W06000011","Urban city and town in a sparse setting",0,0,0,0
"2011","Swansea","W06000011","Rural (total)",28605,28193,412,0
"2011","Swansea","W06000011","Rural town and fringe",13088,12996,92,0
"2011","Swansea","W06000011","Rural town and fringe in a sparse setting",0,0,0,0
"2011","Swansea","W06000011","Rural village",8522,8425,97,0
"2011","Swansea","W06000011","Rural village in a sparse setting",0,0,0,0
"2011","Swansea","W06000011","Rural hamlet and isolated dwellings",6995,6772,223,0
"2011","Swansea","W06000011","Rural hamlet and isolated dwellings in a sparse setting",0,0,0,0
"2011","Neath Port Talbot","W06000012","Total",139812,138682,1130,0
"2011","Neath Port Talbot","W06000012","Urban (total)",106074,105135,939,0
"2011","Neath Port Talbot","W06000012","Urban major conurbation",0,0,0,0
"2011","Neath Port Talbot","W06000012","Urban minor conurbation",0,0,0,0
"2011","Neath Port Talbot","W06000012","Urban city and town",106074,105135,939,0
"2011","Neath Port Talbot","W06000012","Urban city and town in a sparse setting",0,0,0,0
"2011","Neath Port Talbot","W06000012","Rural (total)",33738,33547,191,0
"2011","Neath Port Talbot","W06000012","Rural town and fringe",21033,20934,99,0
"2011","Neath Port Talbot","W06000012","Rural town and fringe in a sparse setting",0,0,0,0
"2011","Neath Port Talbot","W06000012","Rural village",10142,10097,45,0
"2011","Neath Port Talbot","W06000012","Rural village in a sparse setting",0,0,0,0
"2011","Neath Port Talbot","W06000012","Rural hamlet and isolated dwellings",2563,2516,47,0
"2011","Neath Port Talbot","W06000012","Rural hamlet and isolated dwellings in a sparse setting",0,0,0,0
"2011","Bridgend","W06000013","Total",139178,136842,2336,1
"2011","Bridgend","W06000013","Urban (total)",106641,105859,782,0
"2011","Bridgend","W06000013","Urban major conurbation",0,0,0,0
"2011","Bridgend","W06000013","Urban minor conurbation",0,0,0,0
"2011","Bridgend","W06000013","Urban city and town",106641,105859,782,0
"2011","Bridgend","W06000013","Urban city and town in a sparse setting",0,0,0,0
"2011","Bridgend","W06000013","Rural (total)",32537,30983,1554,1
"2011","Bridgend","W06000013","Rural town and fringe",24756,23347,1409,1
"2011","Bridgend","W06000013","Rural town and fringe in a sparse setting",0,0,0,0
"2011","Bridgend","W06000013","Rural village",6313,6168,145,0
"2011","Bridgend","W06000013","Rural village in a sparse setting",0,0,0,0
"2011","Bridgend","W06000013","Rural hamlet and isolated dwellings",1468,1468,0,0
"2011","Bridgend","W06000013","Rural hamlet and isolated dwellings in a sparse setting",0,0,0,0
"2011","The Vale of Glamorgan","W06000014","Total",126336,124259,2077,0
"2011","The Vale of Glamorgan","W06000014","Urban (total)",101808,100166,1642,0
"2011","The Vale of Glamorgan","W06000014","Urban major conurbation",0,0,0,0
"2011","The Vale of Glamorgan","W06000014","Urban minor conurbation",0,0,0,0
"2011","The Vale of Glamorgan","W06000014","Urban city and town",101808,100166,1642,0
"2011","The Vale of Glamorgan","W06000014","Urban city and town in a sparse setting",0,0,0,0
"2011","The Vale of Glamorgan","W06000014","Rural (total)",24528,24093,435,0
"2011","The Vale of Glamorgan","W06000014","Rural town and fringe",8956,8937,19,0
"2011","The Vale of Glamorgan","W06000014","Rural town and fringe in a sparse setting",0,0,0,0
"2011","The Vale of Glamorgan","W06000014","Rural village",13682,13266,416,0
"2011","The Vale of Glamorgan","W06000014","Rural village in a sparse setting",0,0,0,0
"2011","The Vale of Glamorgan","W06000014","Rural hamlet and isolated dwellings",1890,1890,0,0
"2011","The Vale of Glamorgan","W06000014","Rural hamlet and isolated dwellings in a sparse setting",0,0,0,0
"2011","Cardiff","W06000015","Total",346090,334551,11539,0
"2011","Cardiff","W06000015","Urban (total)",340177,328691,11486,0
"2011","Cardiff","W06000015","Urban major conurbation",0,0,0,0
"2011","Cardiff","W06000015","Urban minor conurbation",0,0,0,0
"2011","Cardiff","W06000015","Urban city and town",340177,328691,11486,0
"2011","Cardiff","W06000015","Urban city and town in a sparse setting",0,0,0,0
"2011","Cardiff","W06000015","Rural (total)",5913,5860,53,0
"2011","Cardiff","W06000015","Rural town and fringe",4667,4648,19,0
"2011","Cardiff","W06000015","Rural town and fringe in a sparse setting",0,0,0,0
"2011","Cardiff","W06000015","Rural village",1246,1212,34,0
"2011","Cardiff","W06000015","Rural village in a sparse setting",0,0,0,0
"2011","Cardiff","W06000015","Rural hamlet and isolated dwellings",0,0,0,0
"2011","Cardiff","W06000015","Rural hamlet and isolated dwellings in a sparse setting",0,0,0,0
"2011","Rhondda, Cynon, Taff","W06000016","Total",234410,231885,2525,0
"2011","Rhondda, Cynon, Taff","W06000016","Urban (total)",175566,173390,2176,0
"2011","Rhondda, Cynon, Taff","W06000016","Urban major conurbation",0,0,0,0
"2011","Rhondda, Cynon, Taff","W06000016","Urban minor conurbation",0,0,0,0
"2011","Rhondda, Cynon, Taff","W06000016","Urban city and town",175566,173390,2176,0
"2011","Rhondda, Cynon, Taff","W06000016","Urban city and town in a sparse setting",0,0,0,0
"2011","Rhondda, Cynon, Taff","W06000016","Rural (total)",58844,58495,349,0
"2011","Rhondda, Cynon, Taff","W06000016","Rural town and fringe",52073,51815,258,0
"2011","Rhondda, Cynon, Taff","W06000016","Rural town and fringe in a sparse setting",0,0,0,0
"2011","Rhondda, Cynon, Taff","W06000016","Rural village",3477,3433,44,0
"2011","Rhondda, Cynon, Taff","W06000016","Rural village in a sparse setting",0,0,0,0
"2011","Rhondda, Cynon, Taff","W06000016","Rural hamlet and isolated dwellings",3294,3247,47,0
"2011","Rhondda, Cynon, Taff","W06000016","Rural hamlet and isolated dwellings in a sparse setting",0,0,0,0
"2011","Merthyr Tydfil","W06000024","Total",58802,58334,468,0
"2011","Merthyr Tydfil","W06000024","Urban (total)",51525,51059,466,0
"2011","Merthyr Tydfil","W06000024","Urban major conurbation",0,0,0,0
"2011","Merthyr Tydfil","W06000024","Urban minor conurbation",0,0,0,0
"2011","Merthyr Tydfil","W06000024","Urban city and town",51525,51059,466,0
"2011","Merthyr Tydfil","W06000024","Urban city and town in a sparse setting",0,0,0,0
"2011","Merthyr Tydfil","W06000024","Rural (total)",7277,7275,2,0
"2011","Merthyr Tydfil","W06000024","Rural town and fringe",6472,6472,0,0
"2011","Merthyr Tydfil","W06000024","Rural town and fringe in a sparse setting",0,0,0,0
"2011","Merthyr Tydfil","W06000024","Rural village",576,574,2,0
"2011","Merthyr Tydfil","W06000024","Rural village in a sparse setting",0,0,0,0
"2011","Merthyr Tydfil","W06000024","Rural hamlet and isolated dwellings",229,229,0,0
"2011","Merthyr Tydfil","W06000024","Rural hamlet and isolated dwellings in a sparse setting",0,0,0,0
"2011","Caerphilly","W06000018","Total",178806,177755,1051,1
"2011","Caerphilly","W06000018","Urban (total)",140467,139616,851,1
"2011","Caerphilly","W06000018","Urban major conurbation",0,0,0,0
"2011","Caerphilly","W06000018","Urban minor conurbation",0,0,0,0
"2011","Caerphilly","W06000018","Urban city and town",140467,139616,851,1
"2011","Caerphilly","W06000018","Urban city and town in a sparse setting",0,0,0,0
"2011","Caerphilly","W06000018","Rural (total)",38339,38139,200,0
"2011","Caerphilly","W06000018","Rural town and fringe",31118,30958,160,0
"2011","Caerphilly","W06000018","Rural town and fringe in a sparse setting",0,0,0,0
"2011","Caerphilly","W06000018","Rural village",6125,6085,40,0
"2011","Caerphilly","W06000018","Rural village in a sparse setting",0,0,0,0
"2011","Caerphilly","W06000018","Rural hamlet and isolated dwellings",1096,1096,0,0
"2011","Caerphilly","W06000018","Rural hamlet and isolated dwellings in a sparse setting",0,0,0,0
"2011","Blaenau Gwent","W06000019","Total",69814,69239,575,0
"2011","Blaenau Gwent","W06000019","Urban (total)",60413,59864,549,0
"2011","Blaenau Gwent","W06000019","Urban major conurbation",0,0,0,0
"2011","Blaenau Gwent","W06000019","Urban minor conurbation",0,0,0,0
"2011","Blaenau Gwent","W06000019","Urban city and town",60413,59864,549,0
"2011","Blaenau Gwent","W06000019","Urban city and town in a sparse setting",0,0,0,0
"2011","Blaenau Gwent","W06000019","Rural (total)",9401,9375,26,0
"2011","Blaenau Gwent","W06000019","Rural town and fringe",7240,7234,6,0
"2011","Blaenau Gwent","W06000019","Rural town and fringe in a sparse setting",0,0,0,0
"2011","Blaenau Gwent","W06000019","Rural village",1212,1212,0,0
"2011","Blaenau Gwent","W06000019","Rural village in a sparse setting",0,0,0,0
"2011","Blaenau Gwent","W06000019","Rural hamlet and isolated dwellings",949,929,20,0
"2011","Blaenau Gwent","W06000019","Rural hamlet and isolated dwellings in a sparse setting",0,0,0,0
"2011","Torfaen","W06000020","Total",91075,90360,715,0
"2011","Torfaen","W06000020","Urban (total)",82822,82136,686,0
"2011","Torfaen","W06000020","Urban major conurbation",0,0,0,0
"2011","Torfaen","W06000020","Urban minor conurbation",0,0,0,0
"2011","Torfaen","W06000020","Urban city and town",82822,82136,686,0
"2011","Torfaen","W06000020","Urban city and town in a sparse setting",0,0,0,0
"2011","Torfaen","W06000020","Rural (total)",8253,8224,29,0
"2011","Torfaen","W06000020","Rural town and fringe",6960,6931,29,0
"2011","Torfaen","W06000020","Rural town and fringe in a sparse setting",0,0,0,0
"2011","Torfaen","W06000020","Rural village",577,577,0,0
"2011","Torfaen","W06000020","Rural village in a sparse setting",0,0,0,0
"2011","Torfaen","W06000020","Rural hamlet and isolated dwellings",716,716,0,0
"2011","Torfaen","W06000020","Rural hamlet and isolated dwellings in a sparse setting",0,0,0,0
"2011","Monmouthshire","W06000021","Total",91323,89694,1629,0
"2011","Monmouthshire","W06000021","Urban (total)",48311,47566,745,0
"2011","Monmouthshire","W06000021","Urban major conurbation",0,0,0,0
"2011","Monmouthshire","W06000021","Urban minor conurbation",0,0,0,0
"2011","Monmouthshire","W06000021","Urban city and town",48311,47566,745,0
"2011","Monmouthshire","W06000021","Urban city and town in a sparse setting",0,0,0,0
"2011","Monmouthshire","W06000021","Rural (total)",43012,42128,884,0
"2011","Monmouthshire","W06000021","Rural town and fringe",16765,16259,506,0
"2011","Monmouthshire","W06000021","Rural town and fringe in a sparse setting",0,0,0,0
"2011","Monmouthshire","W06000021","Rural village",10704,10576,128,0
"2011","Monmouthshire","W06000021","Rural village in a sparse setting",0,0,0,0
"2011","Monmouthshire","W06000021","Rural hamlet and isolated dwellings",15543,15293,250,0
"2011","Monmouthshire","W06000021","Rural hamlet and isolated dwellings in a sparse setting",0,0,0,0
"2011","Newport","W06000022","Total",145736,144103,1633,0
"2011","Newport","W06000022","Urban (total)",128060,126620,1440,0
"2011","Newport","W06000022","Urban major conurbation",0,0,0,0
"2011","Newport","W06000022","Urban minor conurbation",0,0,0,0
"2011","Newport","W06000022","Urban city and town",128060,126620,1440,0
"2011","Newport","W06000022","Urban city and town in a sparse setting",0,0,0,0
"2011","Newport","W06000022","Rural (total)",17676,17483,193,0
"2011","Newport","W06000022","Rural town and fringe",12547,12376,171,0
"2011","Newport","W06000022","Rural town and fringe in a sparse setting",0,0,0,0
"2011","Newport","W06000022","Rural village",3981,3959,22,0
"2011","Newport","W06000022","Rural village in a sparse setting",0,0,0,0
"2011","Newport","W06000022","Rural hamlet and isolated dwellings",1148,1148,0,0
"2011","Newport","W06000022","Rural hamlet and isolated dwellings in a sparse setting",0,0,0,0

