"date","geography","geography code","Rural Urban","Variable: All usual residents; measures: Value","Variable: Males; measures: Value","Variable: Females; measures: Value","Variable: Lives in a household; measures: Value","Variable: Lives in a communal establishment; measures: Value","Variable: Schoolchild or full-time student aged 4 and over at their non term-time address; measures: Value","Variable: Area (Hectares); measures: Value","Variable: Density (number of persons per hectare); measures: Value"
"2011","Darlington","E06000005","Total",105564,51483,54081,104111,1453,1218,19747.51,5.3
"2011","Darlington","E06000005","Urban (total)",92363,45026,47337,91122,1241,1010,6113.26,15.1
"2011","Darlington","E06000005","Urban major conurbation",0,0,0,0,0,0,0.00,
"2011","Darlington","E06000005","Urban minor conurbation",0,0,0,0,0,0,0.00,
"2011","Darlington","E06000005","Urban city and town",92363,45026,47337,91122,1241,1010,6113.26,15.1
"2011","Darlington","E06000005","Urban city and town in a sparse setting",0,0,0,0,0,0,0.00,
"2011","Darlington","E06000005","Rural (total)",13201,6457,6744,12989,212,208,13634.25,1.0
"2011","Darlington","E06000005","Rural town and fringe",7770,3805,3965,7747,23,116,1189.13,6.5
"2011","Darlington","E06000005","Rural town and fringe in a sparse setting",0,0,0,0,0,0,0.00,
"2011","Darlington","E06000005","Rural village",3742,1825,1917,3553,189,61,4285.97,0.9
"2011","Darlington","E06000005","Rural village in a sparse setting",0,0,0,0,0,0,0.00,
"2011","Darlington","E06000005","Rural hamlet and isolated dwellings",1689,827,862,1689,0,31,8159.15,0.2
"2011","Darlington","E06000005","Rural hamlet and isolated dwellings in a sparse setting",0,0,0,0,0,0,0.00,
"2011","County Durham","E06000047","Total",513242,251280,261962,500288,12954,4705,222606.26,2.3
"2011","County Durham","E06000047","Urban (total)",281825,137632,144193,271702,10123,2502,21058.65,13.4
"2011","County Durham","E06000047","Urban major conurbation",39407,19025,20382,39097,310,366,3110.94,12.7
"2011","County Durham","E06000047","Urban minor conurbation",0,0,0,0,0,0,0.00,
"2011","County Durham","E06000047","Urban city and town",242418,118607,123811,232605,9813,2136,17947.71,13.5
"2011","County Durham","E06000047","Urban city and town in a sparse setting",0,0,0,0,0,0,0.00,
"2011","County Durham","E06000047","Rural (total)",231417,113648,117769,228586,2831,2203,201547.61,1.1
"2011","County Durham","E06000047","Rural town and fringe",177952,86835,91117,176056,1896,1520,25681.39,6.9
"2011","County Durham","E06000047","Rural town and fringe in a sparse setting",244,121,123,243,1,3,28.00,8.7
"2011","County Durham","E06000047","Rural village",33544,16607,16937,33315,229,396,45113.76,0.7
"2011","County Durham","E06000047","Rural village in a sparse setting",2424,1195,1229,2419,5,35,8294.46,0.3
"2011","County Durham","E06000047","Rural hamlet and isolated dwellings",15348,7934,7414,14654,694,207,79775.28,0.2
"2011","County Durham","E06000047","Rural hamlet and isolated dwellings in a sparse setting",1905,956,949,1899,6,42,42654.72,0.0
"2011","Hartlepool","E06000001","Total",92028,44751,47277,91091,937,780,9386.11,9.8
"2011","Hartlepool","E06000001","Urban (total)",88855,43240,45615,87992,863,733,4161.35,21.4
"2011","Hartlepool","E06000001","Urban major conurbation",0,0,0,0,0,0,0.00,
"2011","Hartlepool","E06000001","Urban minor conurbation",0,0,0,0,0,0,0.00,
"2011","Hartlepool","E06000001","Urban city and town",88855,43240,45615,87992,863,733,4161.35,21.4
"2011","Hartlepool","E06000001","Urban city and town in a sparse setting",0,0,0,0,0,0,0.00,
"2011","Hartlepool","E06000001","Rural (total)",3173,1511,1662,3099,74,47,5224.76,0.6
"2011","Hartlepool","E06000001","Rural town and fringe",742,339,403,742,0,7,46.71,15.9
"2011","Hartlepool","E06000001","Rural town and fringe in a sparse setting",0,0,0,0,0,0,0.00,
"2011","Hartlepool","E06000001","Rural village",1539,752,787,1539,0,27,2142.98,0.7
"2011","Hartlepool","E06000001","Rural village in a sparse setting",0,0,0,0,0,0,0.00,
"2011","Hartlepool","E06000001","Rural hamlet and isolated dwellings",892,420,472,818,74,13,3035.07,0.3
"2011","Hartlepool","E06000001","Rural hamlet and isolated dwellings in a sparse setting",0,0,0,0,0,0,0.00,
"2011","Middlesbrough","E06000002","Total",138412,67732,70680,136156,2256,1040,5387.47,25.7
"2011","Middlesbrough","E06000002","Urban (total)",137455,67262,70193,135218,2237,1021,4747.09,29.0
"2011","Middlesbrough","E06000002","Urban major conurbation",0,0,0,0,0,0,0.00,
"2011","Middlesbrough","E06000002","Urban minor conurbation",0,0,0,0,0,0,0.00,
"2011","Middlesbrough","E06000002","Urban city and town",137455,67262,70193,135218,2237,1021,4747.09,29.0
"2011","Middlesbrough","E06000002","Urban city and town in a sparse setting",0,0,0,0,0,0,0.00,
"2011","Middlesbrough","E06000002","Rural (total)",957,470,487,938,19,19,640.38,1.5
"2011","Middlesbrough","E06000002","Rural town and fringe",592,296,296,592,0,6,125.86,4.7
"2011","Middlesbrough","E06000002","Rural town and fringe in a sparse setting",0,0,0,0,0,0,0.00,
"2011","Middlesbrough","E06000002","Rural village",365,174,191,346,19,13,514.52,0.7
"2011","Middlesbrough","E06000002","Rural village in a sparse setting",0,0,0,0,0,0,0.00,
"2011","Middlesbrough","E06000002","Rural hamlet and isolated dwellings",0,0,0,0,0,0,0.00,
"2011","Middlesbrough","E06000002","Rural hamlet and isolated dwellings in a sparse setting",0,0,0,0,0,0,0.00,
"2011","Northumberland","E06000048","Total",316028,154124,161904,310591,5437,3922,501301.83,0.6
"2011","Northumberland","E06000048","Urban (total)",170932,82653,88279,168670,2262,1770,14073.46,12.1
"2011","Northumberland","E06000048","Urban major conurbation",26699,12837,13862,26468,231,228,1101.62,24.2
"2011","Northumberland","E06000048","Urban minor conurbation",0,0,0,0,0,0,0.00,
"2011","Northumberland","E06000048","Urban city and town",130968,63494,67474,129264,1704,1408,10302.50,12.7
"2011","Northumberland","E06000048","Urban city and town in a sparse setting",13265,6322,6943,12938,327,134,2669.34,5.0
"2011","Northumberland","E06000048","Rural (total)",145096,71471,73625,141921,3175,2152,487228.37,0.3
"2011","Northumberland","E06000048","Rural town and fringe",53488,26444,27044,51966,1522,444,8401.94,6.4
"2011","Northumberland","E06000048","Rural town and fringe in a sparse setting",28831,13940,14891,28483,348,329,8668.67,3.3
"2011","Northumberland","E06000048","Rural village",12880,6348,6532,12566,314,225,15242.88,0.8
"2011","Northumberland","E06000048","Rural village in a sparse setting",16991,8294,8697,16869,122,303,52768.37,0.3
"2011","Northumberland","E06000048","Rural hamlet and isolated dwellings",15983,7881,8102,15529,454,419,107442.45,0.1
"2011","Northumberland","E06000048","Rural hamlet and isolated dwellings in a sparse setting",16923,8564,8359,16508,415,432,294704.06,0.1
"2011","Redcar and Cleveland","E06000003","Total",135177,65655,69522,133929,1248,1096,24489.51,5.5
"2011","Redcar and Cleveland","E06000003","Urban (total)",91297,44132,47165,90532,765,747,6504.96,14.0
"2011","Redcar and Cleveland","E06000003","Urban major conurbation",0,0,0,0,0,0,0.00,
"2011","Redcar and Cleveland","E06000003","Urban minor conurbation",0,0,0,0,0,0,0.00,
"2011","Redcar and Cleveland","E06000003","Urban city and town",91297,44132,47165,90532,765,747,6504.96,14.0
"2011","Redcar and Cleveland","E06000003","Urban city and town in a sparse setting",0,0,0,0,0,0,0.00,
"2011","Redcar and Cleveland","E06000003","Rural (total)",43880,21523,22357,43397,483,349,17984.55,2.4
"2011","Redcar and Cleveland","E06000003","Rural town and fringe",38785,18963,19822,38396,389,302,3894.23,10.0
"2011","Redcar and Cleveland","E06000003","Rural town and fringe in a sparse setting",0,0,0,0,0,0,0.00,
"2011","Redcar and Cleveland","E06000003","Rural village",3136,1562,1574,3073,63,21,3035.37,1.0
"2011","Redcar and Cleveland","E06000003","Rural village in a sparse setting",0,0,0,0,0,0,0.00,
"2011","Redcar and Cleveland","E06000003","Rural hamlet and isolated dwellings",1959,998,961,1928,31,26,11054.95,0.2
"2011","Redcar and Cleveland","E06000003","Rural hamlet and isolated dwellings in a sparse setting",0,0,0,0,0,0,0.00,
"2011","Stockton-on-Tees","E06000004","Total",191610,94082,97528,187959,3651,1991,20393.06,9.4
"2011","Stockton-on-Tees","E06000004","Urban (total)",184074,90373,93701,180512,3562,1851,10288.95,17.9
"2011","Stockton-on-Tees","E06000004","Urban major conurbation",0,0,0,0,0,0,0.00,
"2011","Stockton-on-Tees","E06000004","Urban minor conurbation",0,0,0,0,0,0,0.00,
"2011","Stockton-on-Tees","E06000004","Urban city and town",184074,90373,93701,180512,3562,1851,10288.95,17.9
"2011","Stockton-on-Tees","E06000004","Urban city and town in a sparse setting",0,0,0,0,0,0,0.00,
"2011","Stockton-on-Tees","E06000004","Rural (total)",7536,3709,3827,7447,89,140,10104.11,0.7
"2011","Stockton-on-Tees","E06000004","Rural town and fringe",392,196,196,392,0,1,43.02,9.1
"2011","Stockton-on-Tees","E06000004","Rural town and fringe in a sparse setting",0,0,0,0,0,0,0.00,
"2011","Stockton-on-Tees","E06000004","Rural village",5961,2934,3027,5880,81,120,5045.71,1.2
"2011","Stockton-on-Tees","E06000004","Rural village in a sparse setting",0,0,0,0,0,0,0.00,
"2011","Stockton-on-Tees","E06000004","Rural hamlet and isolated dwellings",1183,579,604,1175,8,19,5015.38,0.2
"2011","Stockton-on-Tees","E06000004","Rural hamlet and isolated dwellings in a sparse setting",0,0,0,0,0,0,0.00,
"2011","Gateshead","E08000020","Total",200214,97974,102240,197726,2488,1332,14234.74,14.1
"2011","Gateshead","E08000020","Urban (total)",184151,90214,93937,181753,2398,1160,6996.06,26.3
"2011","Gateshead","E08000020","Urban major conurbation",181290,88845,92445,178894,2396,1146,6625.79,27.4
"2011","Gateshead","E08000020","Urban minor conurbation",0,0,0,0,0,0,0.00,
"2011","Gateshead","E08000020","Urban city and town",2861,1369,1492,2859,2,14,370.27,7.7
"2011","Gateshead","E08000020","Urban city and town in a sparse setting",0,0,0,0,0,0,0.00,
"2011","Gateshead","E08000020","Rural (total)",16063,7760,8303,15973,90,172,7238.68,2.2
"2011","Gateshead","E08000020","Rural town and fringe",12883,6202,6681,12810,73,127,1449.58,8.9
"2011","Gateshead","E08000020","Rural town and fringe in a sparse setting",0,0,0,0,0,0,0.00,
"2011","Gateshead","E08000020","Rural village",1560,753,807,1560,0,22,926.25,1.7
"2011","Gateshead","E08000020","Rural village in a sparse setting",0,0,0,0,0,0,0.00,
"2011","Gateshead","E08000020","Rural hamlet and isolated dwellings",1620,805,815,1603,17,23,4862.85,0.3
"2011","Gateshead","E08000020","Rural hamlet and isolated dwellings in a sparse setting",0,0,0,0,0,0,0.00,
"2011","Newcastle upon Tyne","E08000021","Total",280177,140226,139951,271212,8965,2586,11343.86,24.7
"2011","Newcastle upon Tyne","E08000021","Urban (total)",274444,137485,136959,265534,8910,2536,7792.86,35.2
"2011","Newcastle upon Tyne","E08000021","Urban major conurbation",273861,137201,136660,264951,8910,2530,7714.64,35.5
"2011","Newcastle upon Tyne","E08000021","Urban minor conurbation",0,0,0,0,0,0,0.00,
"2011","Newcastle upon Tyne","E08000021","Urban city and town",583,284,299,583,0,6,78.22,7.5
"2011","Newcastle upon Tyne","E08000021","Urban city and town in a sparse setting",0,0,0,0,0,0,0.00,
"2011","Newcastle upon Tyne","E08000021","Rural (total)",5733,2741,2992,5678,55,50,3551.00,1.6
"2011","Newcastle upon Tyne","E08000021","Rural town and fringe",4043,1932,2111,4021,22,27,586.71,6.9
"2011","Newcastle upon Tyne","E08000021","Rural town and fringe in a sparse setting",0,0,0,0,0,0,0.00,
"2011","Newcastle upon Tyne","E08000021","Rural village",1690,809,881,1657,33,23,2964.29,0.6
"2011","Newcastle upon Tyne","E08000021","Rural village in a sparse setting",0,0,0,0,0,0,0.00,
"2011","Newcastle upon Tyne","E08000021","Rural hamlet and isolated dwellings",0,0,0,0,0,0,0.00,
"2011","Newcastle upon Tyne","E08000021","Rural hamlet and isolated dwellings in a sparse setting",0,0,0,0,0,0,0.00,
"2011","North Tyneside","E08000022","Total",200801,96883,103918,199142,1659,1550,8239.10,24.4
"2011","North Tyneside","E08000022","Urban (total)",192278,92872,99406,190668,1610,1474,6972.76,27.6
"2011","North Tyneside","E08000022","Urban major conurbation",190512,92016,98496,188905,1607,1461,6688.57,28.5
"2011","North Tyneside","E08000022","Urban minor conurbation",0,0,0,0,0,0,0.00,
"2011","North Tyneside","E08000022","Urban city and town",1766,856,910,1763,3,13,284.19,6.2
"2011","North Tyneside","E08000022","Urban city and town in a sparse setting",0,0,0,0,0,0,0.00,
"2011","North Tyneside","E08000022","Rural (total)",8523,4011,4512,8474,49,76,1266.34,6.7
"2011","North Tyneside","E08000022","Rural town and fringe",7895,3718,4177,7846,49,75,1197.04,6.6
"2011","North Tyneside","E08000022","Rural town and fringe in a sparse setting",0,0,0,0,0,0,0.00,
"2011","North Tyneside","E08000022","Rural village",297,139,158,297,0,0,49.29,6.0
"2011","North Tyneside","E08000022","Rural village in a sparse setting",0,0,0,0,0,0,0.00,
"2011","North Tyneside","E08000022","Rural hamlet and isolated dwellings",331,154,177,331,0,1,20.01,16.5
"2011","North Tyneside","E08000022","Rural hamlet and isolated dwellings in a sparse setting",0,0,0,0,0,0,0.00,
"2011","South Tyneside","E08000023","Total",148127,71560,76567,146729,1398,867,6441.31,23.0
"2011","South Tyneside","E08000023","Urban (total)",147526,71262,76264,146128,1398,863,5558.49,26.5
"2011","South Tyneside","E08000023","Urban major conurbation",141543,68418,73125,140145,1398,815,4937.60,28.7
"2011","South Tyneside","E08000023","Urban minor conurbation",0,0,0,0,0,0,0.00,
"2011","South Tyneside","E08000023","Urban city and town",5983,2844,3139,5983,0,48,620.89,9.6
"2011","South Tyneside","E08000023","Urban city and town in a sparse setting",0,0,0,0,0,0,0.00,
"2011","South Tyneside","E08000023","Rural (total)",601,298,303,601,0,4,882.82,0.7
"2011","South Tyneside","E08000023","Rural town and fringe",327,166,161,327,0,2,24.12,13.6
"2011","South Tyneside","E08000023","Rural town and fringe in a sparse setting",0,0,0,0,0,0,0.00,
"2011","South Tyneside","E08000023","Rural village",0,0,0,0,0,0,0.00,
"2011","South Tyneside","E08000023","Rural village in a sparse setting",0,0,0,0,0,0,0.00,
"2011","South Tyneside","E08000023","Rural hamlet and isolated dwellings",274,132,142,274,0,2,858.70,0.3
"2011","South Tyneside","E08000023","Rural hamlet and isolated dwellings in a sparse setting",0,0,0,0,0,0,0.00,
"2011","Sunderland","E08000024","Total",275506,133953,141553,271884,3622,1531,13746.17,20.0
"2011","Sunderland","E08000024","Urban (total)",274013,133246,140767,270391,3622,1516,12483.55,21.9
"2011","Sunderland","E08000024","Urban major conurbation",273097,132796,140301,269475,3622,1511,12354.33,22.1
"2011","Sunderland","E08000024","Urban minor conurbation",0,0,0,0,0,0,0.00,
"2011","Sunderland","E08000024","Urban city and town",916,450,466,916,0,5,129.22,7.1
"2011","Sunderland","E08000024","Urban city and town in a sparse setting",0,0,0,0,0,0,0.00,
"2011","Sunderland","E08000024","Rural (total)",1493,707,786,1493,0,15,1262.62,1.2
"2011","Sunderland","E08000024","Rural town and fringe",1213,564,649,1213,0,5,310.21,3.9
"2011","Sunderland","E08000024","Rural town and fringe in a sparse setting",0,0,0,0,0,0,0.00,
"2011","Sunderland","E08000024","Rural village",0,0,0,0,0,0,0.00,
"2011","Sunderland","E08000024","Rural village in a sparse setting",0,0,0,0,0,0,0.00,
"2011","Sunderland","E08000024","Rural hamlet and isolated dwellings",280,143,137,280,0,10,952.41,0.3
"2011","Sunderland","E08000024","Rural hamlet and isolated dwellings in a sparse setting",0,0,0,0,0,0,0.00,
"2011","Blackburn with Darwen","E06000008","Total",147489,73547,73942,145827,1662,1467,13701.18,10.8
"2011","Blackburn with Darwen","E06000008","Urban (total)",140558,70124,70434,138896,1662,1314,4968.38,28.3
"2011","Blackburn with Darwen","E06000008","Urban major conurbation",0,0,0,0,0,0,0.00,
"2011","Blackburn with Darwen","E06000008","Urban minor conurbation",0,0,0,0,0,0,0.00,
"2011","Blackburn with Darwen","E06000008","Urban city and town",140558,70124,70434,138896,1662,1314,4968.38,28.3
"2011","Blackburn with Darwen","E06000008","Urban city and town in a sparse setting",0,0,0,0,0,0,0.00,
"2011","Blackburn with Darwen","E06000008","Rural (total)",6931,3423,3508,6931,0,153,8732.80,0.8
"2011","Blackburn with Darwen","E06000008","Rural town and fringe",2612,1289,1323,2612,0,53,530.40,4.9
"2011","Blackburn with Darwen","E06000008","Rural town and fringe in a sparse setting",0,0,0,0,0,0,0.00,
"2011","Blackburn with Darwen","E06000008","Rural village",2378,1189,1189,2378,0,50,4167.64,0.6
"2011","Blackburn with Darwen","E06000008","Rural village in a sparse setting",0,0,0,0,0,0,0.00,
"2011","Blackburn with Darwen","E06000008","Rural hamlet and isolated dwellings",1941,945,996,1941,0,50,4034.76,0.5
"2011","Blackburn with Darwen","E06000008","Rural hamlet and isolated dwellings in a sparse setting",0,0,0,0,0,0,0.00,
"2011","Blackpool","E06000009","Total",142065,69775,72290,137960,4105,1073,3488.10,40.7
"2011","Blackpool","E06000009","Urban (total)",141510,69505,72005,137405,4105,1068,3434.12,41.2
"2011","Blackpool","E06000009","Urban major conurbation",0,0,0,0,0,0,0.00,
"2011","Blackpool","E06000009","Urban minor conurbation",0,0,0,0,0,0,0.00,
"2011","Blackpool","E06000009","Urban city and town",141510,69505,72005,137405,4105,1068,3434.12,41.2
"2011","Blackpool","E06000009","Urban city and town in a sparse setting",0,0,0,0,0,0,0.00,
"2011","Blackpool","E06000009","Rural (total)",555,270,285,555,0,5,53.98,10.3
"2011","Blackpool","E06000009","Rural town and fringe",555,270,285,555,0,5,53.98,10.3
"2011","Blackpool","E06000009","Rural town and fringe in a sparse setting",0,0,0,0,0,0,0.00,
"2011","Blackpool","E06000009","Rural village",0,0,0,0,0,0,0.00,
"2011","Blackpool","E06000009","Rural village in a sparse setting",0,0,0,0,0,0,0.00,
"2011","Blackpool","E06000009","Rural hamlet and isolated dwellings",0,0,0,0,0,0,0.00,
"2011","Blackpool","E06000009","Rural hamlet and isolated dwellings in a sparse setting",0,0,0,0,0,0,0.00,
"2011","Cheshire East","E06000049","Total",370127,181409,188718,365065,5062,6056,116637.63,3.2
"2011","Cheshire East","E06000049","Urban (total)",299520,146779,152741,296980,2540,4442,19932.05,15.0
"2011","Cheshire East","E06000049","Urban major conurbation",45501,22147,23354,45109,392,996,2630.51,17.3
"2011","Cheshire East","E06000049","Urban minor conurbation",0,0,0,0,0,0,0.00,
"2011","Cheshire East","E06000049","Urban city and town",254019,124632,129387,251871,2148,3446,17301.54,14.7
"2011","Cheshire East","E06000049","Urban city and town in a sparse setting",0,0,0,0,0,0,0.00,
"2011","Cheshire East","E06000049","Rural (total)",70607,34630,35977,68085,2522,1614,96705.58,0.7
"2011","Cheshire East","E06000049","Rural town and fringe",20733,10031,10702,20488,245,408,3027.04,6.8
"2011","Cheshire East","E06000049","Rural town and fringe in a sparse setting",0,0,0,0,0,0,0.00,
"2011","Cheshire East","E06000049","Rural village",21405,10469,10936,21142,263,426,18588.78,1.2
"2011","Cheshire East","E06000049","Rural village in a sparse setting",0,0,0,0,0,0,0.00,
"2011","Cheshire East","E06000049","Rural hamlet and isolated dwellings",28469,14130,14339,26455,2014,780,75089.76,0.4
"2011","Cheshire East","E06000049","Rural hamlet and isolated dwellings in a sparse setting",0,0,0,0,0,0,0.00,
"2011","Cheshire West and Chester","E06000050","Total",329608,160586,169022,326236,3372,4753,91665.60,3.6
"2011","Cheshire West and Chester","E06000050","Urban (total)",243307,118435,124872,240912,2395,2943,18003.83,13.5
"2011","Cheshire West and Chester","E06000050","Urban major conurbation",0,0,0,0,0,0,0.00,
"2011","Cheshire West and Chester","E06000050","Urban minor conurbation",0,0,0,0,0,0,0.00,
"2011","Cheshire West and Chester","E06000050","Urban city and town",243307,118435,124872,240912,2395,2943,18003.83,13.5
"2011","Cheshire West and Chester","E06000050","Urban city and town in a sparse setting",0,0,0,0,0,0,0.00,
"2011","Cheshire West and Chester","E06000050","Rural (total)",86301,42151,44150,85324,977,1810,73661.77,1.2
"2011","Cheshire West and Chester","E06000050","Rural town and fringe",45067,21756,23311,44653,414,817,7229.35,6.2
"2011","Cheshire West and Chester","E06000050","Rural town and fringe in a sparse setting",0,0,0,0,0,0,0.00,
"2011","Cheshire West and Chester","E06000050","Rural village",20335,9961,10374,20018,317,443,20861.19,1.0
"2011","Cheshire West and Chester","E06000050","Rural village in a sparse setting",0,0,0,0,0,0,0.00,
"2011","Cheshire West and Chester","E06000050","Rural hamlet and isolated dwellings",20899,10434,10465,20653,246,550,45571.23,0.5
"2011","Cheshire West and Chester","E06000050","Rural hamlet and isolated dwellings in a sparse setting",0,0,0,0,0,0,0.00,
"2011","Halton","E06000006","Total",125746,61368,64378,124874,872,1001,7909.52,15.9
"2011","Halton","E06000006","Urban (total)",122598,59806,62792,121726,872,965,6452.94,19.0
"2011","Halton","E06000006","Urban major conurbation",0,0,0,0,0,0,0.00,
"2011","Halton","E06000006","Urban minor conurbation",0,0,0,0,0,0,0.00,
"2011","Halton","E06000006","Urban city and town",122598,59806,62792,121726,872,965,6452.94,19.0
"2011","Halton","E06000006","Urban city and town in a sparse setting",0,0,0,0,0,0,0.00,
"2011","Halton","E06000006","Rural (total)",3148,1562,1586,3148,0,36,1456.58,2.2
"2011","Halton","E06000006","Rural town and fringe",2188,1080,1108,2188,0,21,591.81,3.7
"2011","Halton","E06000006","Rural town and fringe in a sparse setting",0,0,0,0,0,0,0.00,
"2011","Halton","E06000006","Rural village",714,356,358,714,0,11,81.67,8.7
"2011","Halton","E06000006","Rural village in a sparse setting",0,0,0,0,0,0,0.00,
"2011","Halton","E06000006","Rural hamlet and isolated dwellings",246,126,120,246,0,4,783.10,0.3
"2011","Halton","E06000006","Rural hamlet and isolated dwellings in a sparse setting",0,0,0,0,0,0,0.00,
"2011","Warrington","E06000007","Total",202228,100300,101928,198828,3400,2589,18065.39,11.2
"2011","Warrington","E06000007","Urban (total)",177064,87415,89649,175392,1672,2178,8518.82,20.8
"2011","Warrington","E06000007","Urban major conurbation",0,0,0,0,0,0,0.00,
"2011","Warrington","E06000007","Urban minor conurbation",0,0,0,0,0,0,0.00,
"2011","Warrington","E06000007","Urban city and town",177064,87415,89649,175392,1672,2178,8518.82,20.8
"2011","Warrington","E06000007","Urban city and town in a sparse setting",0,0,0,0,0,0,0.00,
"2011","Warrington","E06000007","Rural (total)",25164,12885,12279,23436,1728,411,9546.57,2.6
"2011","Warrington","E06000007","Rural town and fringe",15229,7862,7367,14044,1185,228,1905.30,8.0
"2011","Warrington","E06000007","Rural town and fringe in a sparse setting",0,0,0,0,0,0,0.00,
"2011","Warrington","E06000007","Rural village",5637,2923,2714,5213,424,107,2058.43,2.7
"2011","Warrington","E06000007","Rural village in a sparse setting",0,0,0,0,0,0,0.00,
"2011","Warrington","E06000007","Rural hamlet and isolated dwellings",4298,2100,2198,4179,119,76,5582.84,0.8
"2011","Warrington","E06000007","Rural hamlet and isolated dwellings in a sparse setting",0,0,0,0,0,0,0.00,
"2011","Cumbria","E10000006","Total",499858,246065,253793,490939,8919,6584,676655.85,0.7
"2011","Cumbria","E10000006","Urban (total)",232039,113702,118337,229124,2915,2438,15089.24,15.4
"2011","Cumbria","E10000006","Urban major conurbation",0,0,0,0,0,0,0.00,
"2011","Cumbria","E10000006","Urban minor conurbation",0,0,0,0,0,0,0.00,
"2011","Cumbria","E10000006","Urban city and town",217427,106583,110844,214771,2656,2260,14112.76,15.4
"2011","Cumbria","E10000006","Urban city and town in a sparse setting",14612,7119,7493,14353,259,178,976.48,15.0
"2011","Cumbria","E10000006","Rural (total)",267819,132363,135456,261815,6004,4146,661566.61,0.4
"2011","Cumbria","E10000006","Rural town and fringe",102684,50187,52497,101508,1176,1157,14661.99,7.0
"2011","Cumbria","E10000006","Rural town and fringe in a sparse setting",28517,13821,14696,27511,1006,427,3898.83,7.3
"2011","Cumbria","E10000006","Rural village",48425,24088,24337,47297,1128,878,71052.03,0.7
"2011","Cumbria","E10000006","Rural village in a sparse setting",37116,18390,18726,36081,1035,636,149347.75,0.2
"2011","Cumbria","E10000006","Rural hamlet and isolated dwellings",26843,13575,13268,26425,418,509,138020.83,0.2
"2011","Cumbria","E10000006","Rural hamlet and isolated dwellings in a sparse setting",24234,12302,11932,22993,1241,539,284585.18,0.1
"2011","Bolton","E08000001","Total",276786,136660,140126,274855,1931,2747,13980.34,19.8
"2011","Bolton","E08000001","Urban (total)",274298,135399,138899,272367,1931,2718,11440.06,24.0
"2011","Bolton","E08000001","Urban major conurbation",246862,122010,124852,245178,1684,2390,9421.61,26.2
"2011","Bolton","E08000001","Urban minor conurbation",0,0,0,0,0,0,0.00,
"2011","Bolton","E08000001","Urban city and town",27436,13389,14047,27189,247,328,2018.45,13.6
"2011","Bolton","E08000001","Urban city and town in a sparse setting",0,0,0,0,0,0,0.00,
"2011","Bolton","E08000001","Rural (total)",2488,1261,1227,2488,0,29,2540.28,1.0
"2011","Bolton","E08000001","Rural town and fringe",560,282,278,560,0,8,631.02,0.9
"2011","Bolton","E08000001","Rural town and fringe in a sparse setting",0,0,0,0,0,0,0.00,
"2011","Bolton","E08000001","Rural village",474,237,237,474,0,7,140.52,3.4
"2011","Bolton","E08000001","Rural village in a sparse setting",0,0,0,0,0,0,0.00,
"2011","Bolton","E08000001","Rural hamlet and isolated dwellings",1454,742,712,1454,0,14,1768.74,0.8
"2011","Bolton","E08000001","Rural hamlet and isolated dwellings in a sparse setting",0,0,0,0,0,0,0.00,
"2011","Bury","E08000002","Total",185060,90588,94472,183025,2035,2472,9948.44,18.6
"2011","Bury","E08000002","Urban (total)",179934,88104,91830,178111,1823,2400,8173.17,22.0
"2011","Bury","E08000002","Urban major conurbation",179215,87753,91462,177392,1823,2392,8115.37,22.1
"2011","Bury","E08000002","Urban minor conurbation",0,0,0,0,0,0,0.00,
"2011","Bury","E08000002","Urban city and town",719,351,368,719,0,8,57.80,12.4
"2011","Bury","E08000002","Urban city and town in a sparse setting",0,0,0,0,0,0,0.00,
"2011","Bury","E08000002","Rural (total)",5126,2484,2642,4914,212,72,1775.27,2.9
"2011","Bury","E08000002","Rural town and fringe",2258,1081,1177,2255,3,26,529.35,4.3
"2011","Bury","E08000002","Rural town and fringe in a sparse setting",0,0,0,0,0,0,0.00,
"2011","Bury","E08000002","Rural village",2061,1026,1035,1971,90,34,649.48,3.2
"2011","Bury","E08000002","Rural village in a sparse setting",0,0,0,0,0,0,0.00,
"2011","Bury","E08000002","Rural hamlet and isolated dwellings",807,377,430,688,119,12,596.44,1.4
"2011","Bury","E08000002","Rural hamlet and isolated dwellings in a sparse setting",0,0,0,0,0,0,0.00,
"2011","Manchester","E08000003","Total",503127,252623,250504,481030,22097,3736,11564.49,43.5
"2011","Manchester","E08000003","Urban (total)",503024,252566,250458,480927,22097,3735,10909.47,46.1
"2011","Manchester","E08000003","Urban major conurbation",503024,252566,250458,480927,22097,3735,10909.47,46.1
"2011","Manchester","E08000003","Urban minor conurbation",0,0,0,0,0,0,0.00,
"2011","Manchester","E08000003","Urban city and town",0,0,0,0,0,0,0.00,
"2011","Manchester","E08000003","Urban city and town in a sparse setting",0,0,0,0,0,0,0.00,
"2011","Manchester","E08000003","Rural (total)",103,57,46,103,0,1,655.02,0.2
"2011","Manchester","E08000003","Rural town and fringe",0,0,0,0,0,0,0.00,
"2011","Manchester","E08000003","Rural town and fringe in a sparse setting",0,0,0,0,0,0,0.00,
"2011","Manchester","E08000003","Rural village",0,0,0,0,0,0,0.00,
"2011","Manchester","E08000003","Rural village in a sparse setting",0,0,0,0,0,0,0.00,
"2011","Manchester","E08000003","Rural hamlet and isolated dwellings",103,57,46,103,0,1,655.02,0.2
"2011","Manchester","E08000003","Rural hamlet and isolated dwellings in a sparse setting",0,0,0,0,0,0,0.00,
"2011","Oldham","E08000004","Total",224897,110155,114742,223170,1727,2118,14236.49,15.8
"2011","Oldham","E08000004","Urban (total)",222240,108831,113409,220552,1688,2067,10806.73,20.6
"2011","Oldham","E08000004","Urban major conurbation",214910,105199,109711,213250,1660,1917,6935.35,31.0
"2011","Oldham","E08000004","Urban minor conurbation",0,0,0,0,0,0,0.00,
"2011","Oldham","E08000004","Urban city and town",7330,3632,3698,7302,28,150,3871.38,1.9
"2011","Oldham","E08000004","Urban city and town in a sparse setting",0,0,0,0,0,0,0.00,
"2011","Oldham","E08000004","Rural (total)",2657,1324,1333,2618,39,51,3429.76,0.8
"2011","Oldham","E08000004","Rural town and fringe",355,157,198,316,39,1,200.48,1.8
"2011","Oldham","E08000004","Rural town and fringe in a sparse setting",0,0,0,0,0,0,0.00,
"2011","Oldham","E08000004","Rural village",305,159,146,305,0,8,77.05,4.0
"2011","Oldham","E08000004","Rural village in a sparse setting",0,0,0,0,0,0,0.00,
"2011","Oldham","E08000004","Rural hamlet and isolated dwellings",1997,1008,989,1997,0,42,3152.23,0.6
"2011","Oldham","E08000004","Rural hamlet and isolated dwellings in a sparse setting",0,0,0,0,0,0,0.00,
"2011","Rochdale","E08000005","Total",211699,103642,108057,209552,2147,2083,15808.07,13.4
"2011","Rochdale","E08000005","Urban (total)",209122,102352,106770,207042,2080,2050,9318.77,22.4
"2011","Rochdale","E08000005","Urban major conurbation",205920,100761,105159,203859,2061,1996,8713.12,23.6
"2011","Rochdale","E08000005","Urban minor conurbation",0,0,0,0,0,0,0.00,
"2011","Rochdale","E08000005","Urban city and town",3202,1591,1611,3183,19,54,605.65,5.3
"2011","Rochdale","E08000005","Urban city and town in a sparse setting",0,0,0,0,0,0,0.00,
"2011","Rochdale","E08000005","Rural (total)",2577,1290,1287,2510,67,33,6489.30,0.4
"2011","Rochdale","E08000005","Rural town and fringe",541,252,289,480,61,7,445.73,1.2
"2011","Rochdale","E08000005","Rural town and fringe in a sparse setting",0,0,0,0,0,0,0.00,
"2011","Rochdale","E08000005","Rural village",523,263,260,522,1,9,2006.70,0.3
"2011","Rochdale","E08000005","Rural village in a sparse setting",0,0,0,0,0,0,0.00,
"2011","Rochdale","E08000005","Rural hamlet and isolated dwellings",1513,775,738,1508,5,17,4036.87,0.4
"2011","Rochdale","E08000005","Rural hamlet and isolated dwellings in a sparse setting",0,0,0,0,0,0,0.00,
"2011","Salford","E08000006","Total",233933,116782,117151,228346,5587,2045,9719.02,24.1
"2011","Salford","E08000006","Urban (total)",233649,116636,117013,228062,5587,2042,8805.75,26.5
"2011","Salford","E08000006","Urban major conurbation",233649,116636,117013,228062,5587,2042,8805.75,26.5
"2011","Salford","E08000006","Urban minor conurbation",0,0,0,0,0,0,0.00,
"2011","Salford","E08000006","Urban city and town",0,0,0,0,0,0,0.00,
"2011","Salford","E08000006","Urban city and town in a sparse setting",0,0,0,0,0,0,0.00,
"2011","Salford","E08000006","Rural (total)",284,146,138,284,0,3,913.27,0.3
"2011","Salford","E08000006","Rural town and fringe",0,0,0,0,0,0,0.00,
"2011","Salford","E08000006","Rural town and fringe in a sparse setting",0,0,0,0,0,0,0.00,
"2011","Salford","E08000006","Rural village",0,0,0,0,0,0,0.00,
"2011","Salford","E08000006","Rural village in a sparse setting",0,0,0,0,0,0,0.00,
"2011","Salford","E08000006","Rural hamlet and isolated dwellings",284,146,138,284,0,3,913.27,0.3
"2011","Salford","E08000006","Rural hamlet and isolated dwellings in a sparse setting",0,0,0,0,0,0,0.00,
"2011","Stockport","E08000007","Total",283275,138400,144875,280915,2360,3722,12606.18,22.5
"2011","Stockport","E08000007","Urban (total)",282026,137771,144255,279682,2344,3699,10937.68,25.8
"2011","Stockport","E08000007","Urban major conurbation",274713,134230,140483,272413,2300,3585,9631.24,28.5
"2011","Stockport","E08000007","Urban minor conurbation",0,0,0,0,0,0,0.00,
"2011","Stockport","E08000007","Urban city and town",7313,3541,3772,7269,44,114,1306.44,5.6
"2011","Stockport","E08000007","Urban city and town in a sparse setting",0,0,0,0,0,0,0.00,
"2011","Stockport","E08000007","Rural (total)",1249,629,620,1233,16,23,1668.50,0.7
"2011","Stockport","E08000007","Rural town and fringe",0,0,0,0,0,0,0.00,
"2011","Stockport","E08000007","Rural town and fringe in a sparse setting",0,0,0,0,0,0,0.00,
"2011","Stockport","E08000007","Rural village",0,0,0,0,0,0,0.00,
"2011","Stockport","E08000007","Rural village in a sparse setting",0,0,0,0,0,0,0.00,
"2011","Stockport","E08000007","Rural hamlet and isolated dwellings",1249,629,620,1233,16,23,1668.50,0.7
"2011","Stockport","E08000007","Rural hamlet and isolated dwellings in a sparse setting",0,0,0,0,0,0,0.00,
"2011","Tameside","E08000008","Total",219324,107650,111674,217736,1588,1769,10317.14,21.3
"2011","Tameside","E08000008","Urban (total)",218679,107323,111356,217091,1588,1759,9537.44,22.9
"2011","Tameside","E08000008","Urban major conurbation",216647,106297,110350,215059,1588,1730,9334.80,23.2
"2011","Tameside","E08000008","Urban minor conurbation",0,0,0,0,0,0,0.00,
"2011","Tameside","E08000008","Urban city and town",2032,1026,1006,2032,0,29,202.64,10.0
"2011","Tameside","E08000008","Urban city and town in a sparse setting",0,0,0,0,0,0,0.00,
"2011","Tameside","E08000008","Rural (total)",645,327,318,645,0,10,779.70,0.8
"2011","Tameside","E08000008","Rural town and fringe",0,0,0,0,0,0,0.00,
"2011","Tameside","E08000008","Rural town and fringe in a sparse setting",0,0,0,0,0,0,0.00,
"2011","Tameside","E08000008","Rural village",0,0,0,0,0,0,0.00,
"2011","Tameside","E08000008","Rural village in a sparse setting",0,0,0,0,0,0,0.00,
"2011","Tameside","E08000008","Rural hamlet and isolated dwellings",645,327,318,645,0,10,779.70,0.8
"2011","Tameside","E08000008","Rural hamlet and isolated dwellings in a sparse setting",0,0,0,0,0,0,0.00,
"2011","Trafford","E08000009","Total",226578,110959,115619,225277,1301,3435,10603.73,21.4
"2011","Trafford","E08000009","Urban (total)",225754,110542,115212,224453,1301,3419,8852.66,25.5
"2011","Trafford","E08000009","Urban major conurbation",221223,108368,112855,219922,1301,3241,7485.84,29.6
"2011","Trafford","E08000009","Urban minor conurbation",0,0,0,0,0,0,0.00,
"2011","Trafford","E08000009","Urban city and town",4531,2174,2357,4531,0,178,1366.82,3.3
"2011","Trafford","E08000009","Urban city and town in a sparse setting",0,0,0,0,0,0,0.00,
"2011","Trafford","E08000009","Rural (total)",824,417,407,824,0,16,1751.07,0.5
"2011","Trafford","E08000009","Rural town and fringe",0,0,0,0,0,0,0.00,
"2011","Trafford","E08000009","Rural town and fringe in a sparse setting",0,0,0,0,0,0,0.00,
"2011","Trafford","E08000009","Rural village",585,293,292,585,0,11,1200.75,0.5
"2011","Trafford","E08000009","Rural village in a sparse setting",0,0,0,0,0,0,0.00,
"2011","Trafford","E08000009","Rural hamlet and isolated dwellings",239,124,115,239,0,5,550.32,0.4
"2011","Trafford","E08000009","Rural hamlet and isolated dwellings in a sparse setting",0,0,0,0,0,0,0.00,
"2011","Wigan","E08000010","Total",317849,157996,159853,315794,2055,2601,18819.15,16.9
"2011","Wigan","E08000010","Urban (total)",306293,152111,154182,304450,1843,2495,15102.40,20.3
"2011","Wigan","E08000010","Urban major conurbation",300645,149294,151351,298848,1797,2427,14029.53,21.4
"2011","Wigan","E08000010","Urban minor conurbation",0,0,0,0,0,0,0.00,
"2011","Wigan","E08000010","Urban city and town",5648,2817,2831,5602,46,68,1072.87,5.3
"2011","Wigan","E08000010","Urban city and town in a sparse setting",0,0,0,0,0,0,0.00,
"2011","Wigan","E08000010","Rural (total)",11556,5885,5671,11344,212,106,3716.75,3.1
"2011","Wigan","E08000010","Rural town and fringe",7928,3978,3950,7928,0,75,707.52,11.2
"2011","Wigan","E08000010","Rural town and fringe in a sparse setting",0,0,0,0,0,0,0.00,
"2011","Wigan","E08000010","Rural village",2331,1280,1051,2119,212,11,855.88,2.7
"2011","Wigan","E08000010","Rural village in a sparse setting",0,0,0,0,0,0,0.00,
"2011","Wigan","E08000010","Rural hamlet and isolated dwellings",1297,627,670,1297,0,20,2153.35,0.6
"2011","Wigan","E08000010","Rural hamlet and isolated dwellings in a sparse setting",0,0,0,0,0,0,0.00,
"2011","Lancashire","E10000017","Total",1171339,575146,596193,1143277,28062,14049,290320.20,4.0
"2011","Lancashire","E10000017","Urban (total)",929629,455417,474212,912912,16717,10280,59535.81,15.6
"2011","Lancashire","E10000017","Urban major conurbation",41647,20343,21304,41344,303,349,2592.33,16.1
"2011","Lancashire","E10000017","Urban minor conurbation",0,0,0,0,0,0,0.00,
"2011","Lancashire","E10000017","Urban city and town",887982,435074,452908,871568,16414,9931,56943.48,15.6
"2011","Lancashire","E10000017","Urban city and town in a sparse setting",0,0,0,0,0,0,0.00,
"2011","Lancashire","E10000017","Rural (total)",241710,119729,121981,230365,11345,3769,230784.39,1.0
"2011","Lancashire","E10000017","Rural town and fringe",130300,63482,66818,127548,2752,1710,21019.74,6.2
"2011","Lancashire","E10000017","Rural town and fringe in a sparse setting",0,0,0,0,0,0,0.00,
"2011","Lancashire","E10000017","Rural village",55508,28361,27147,52917,2591,900,46566.24,1.2
"2011","Lancashire","E10000017","Rural village in a sparse setting",0,0,0,0,0,0,0.00,
"2011","Lancashire","E10000017","Rural hamlet and isolated dwellings",55460,27665,27795,49460,6000,1149,159879.30,0.3
"2011","Lancashire","E10000017","Rural hamlet and isolated dwellings in a sparse setting",442,221,221,440,2,10,3319.11,0.1
"2011","Knowsley","E08000011","Total",145893,69329,76564,144990,903,781,8646.93,16.9
"2011","Knowsley","E08000011","Urban (total)",144900,68867,76033,143997,903,775,7591.84,19.1
"2011","Knowsley","E08000011","Urban major conurbation",140576,66741,73835,139673,903,726,5152.03,27.3
"2011","Knowsley","E08000011","Urban minor conurbation",0,0,0,0,0,0,0.00,
"2011","Knowsley","E08000011","Urban city and town",4324,2126,2198,4324,0,49,2439.81,1.8
"2011","Knowsley","E08000011","Urban city and town in a sparse setting",0,0,0,0,0,0,0.00,
"2011","Knowsley","E08000011","Rural (total)",993,462,531,993,0,6,1055.09,0.9
"2011","Knowsley","E08000011","Rural town and fringe",299,127,172,299,0,0,9.66,31.0
"2011","Knowsley","E08000011","Rural town and fringe in a sparse setting",0,0,0,0,0,0,0.00,
"2011","Knowsley","E08000011","Rural village",0,0,0,0,0,0,0.00,
"2011","Knowsley","E08000011","Rural village in a sparse setting",0,0,0,0,0,0,0.00,
"2011","Knowsley","E08000011","Rural hamlet and isolated dwellings",694,335,359,694,0,6,1045.43,0.7
"2011","Knowsley","E08000011","Rural hamlet and isolated dwellings in a sparse setting",0,0,0,0,0,0,0.00,
"2011","Liverpool","E08000012","Total",466415,230483,235932,450085,16330,3283,11184.35,41.7
"2011","Liverpool","E08000012","Urban (total)",466415,230483,235932,450085,16330,3283,11184.35,41.7
"2011","Liverpool","E08000012","Urban major conurbation",466415,230483,235932,450085,16330,3283,11184.35,41.7
"2011","Liverpool","E08000012","Urban minor conurbation",0,0,0,0,0,0,0.00,
"2011","Liverpool","E08000012","Urban city and town",0,0,0,0,0,0,0.00,
"2011","Liverpool","E08000012","Urban city and town in a sparse setting",0,0,0,0,0,0,0.00,
"2011","Liverpool","E08000012","Rural (total)",0,0,0,0,0,0,0.00,
"2011","Liverpool","E08000012","Rural town and fringe",0,0,0,0,0,0,0.00,
"2011","Liverpool","E08000012","Rural town and fringe in a sparse setting",0,0,0,0,0,0,0.00,
"2011","Liverpool","E08000012","Rural village",0,0,0,0,0,0,0.00,
"2011","Liverpool","E08000012","Rural village in a sparse setting",0,0,0,0,0,0,0.00,
"2011","Liverpool","E08000012","Rural hamlet and isolated dwellings",0,0,0,0,0,0,0.00,
"2011","Liverpool","E08000012","Rural hamlet and isolated dwellings in a sparse setting",0,0,0,0,0,0,0.00,
"2011","Sefton","E08000014","Total",273790,131237,142553,269697,4093,3000,15313.61,17.9
"2011","Sefton","E08000014","Urban (total)",269811,129299,140512,265751,4060,2940,12171.66,22.2
"2011","Sefton","E08000014","Urban major conurbation",154733,74164,80569,153298,1435,1350,5030.94,30.8
"2011","Sefton","E08000014","Urban minor conurbation",0,0,0,0,0,0,0.00,
"2011","Sefton","E08000014","Urban city and town",115078,55135,59943,112453,2625,1590,7140.72,16.1
"2011","Sefton","E08000014","Urban city and town in a sparse setting",0,0,0,0,0,0,0.00,
"2011","Sefton","E08000014","Rural (total)",3979,1938,2041,3946,33,60,3141.95,1.3
"2011","Sefton","E08000014","Rural town and fringe",2063,1016,1047,2063,0,47,287.85,7.2
"2011","Sefton","E08000014","Rural town and fringe in a sparse setting",0,0,0,0,0,0,0.00,
"2011","Sefton","E08000014","Rural village",1107,530,577,1074,33,7,1825.88,0.6
"2011","Sefton","E08000014","Rural village in a sparse setting",0,0,0,0,0,0,0.00,
"2011","Sefton","E08000014","Rural hamlet and isolated dwellings",809,392,417,809,0,6,1028.22,0.8
"2011","Sefton","E08000014","Rural hamlet and isolated dwellings in a sparse setting",0,0,0,0,0,0,0.00,
"2011","St. Helens","E08000013","Total",175308,86138,89170,173958,1350,1499,13638.25,12.9
"2011","St. Helens","E08000013","Urban (total)",165579,81309,84270,164370,1209,1384,8791.30,18.8
"2011","St. Helens","E08000013","Urban major conurbation",158483,77940,80543,157331,1152,1267,7526.58,21.1
"2011","St. Helens","E08000013","Urban minor conurbation",0,0,0,0,0,0,0.00,
"2011","St. Helens","E08000013","Urban city and town",7096,3369,3727,7039,57,117,1264.72,5.6
"2011","St. Helens","E08000013","Urban city and town in a sparse setting",0,0,0,0,0,0,0.00,
"2011","St. Helens","E08000013","Rural (total)",9729,4829,4900,9588,141,115,4846.95,2.0
"2011","St. Helens","E08000013","Rural town and fringe",8131,4051,4080,7992,139,99,1162.44,7.0
"2011","St. Helens","E08000013","Rural town and fringe in a sparse setting",0,0,0,0,0,0,0.00,
"2011","St. Helens","E08000013","Rural village",345,165,180,343,2,4,345.49,1.0
"2011","St. Helens","E08000013","Rural village in a sparse setting",0,0,0,0,0,0,0.00,
"2011","St. Helens","E08000013","Rural hamlet and isolated dwellings",1253,613,640,1253,0,12,3339.02,0.4
"2011","St. Helens","E08000013","Rural hamlet and isolated dwellings in a sparse setting",0,0,0,0,0,0,0.00,
"2011","Wirral","E08000015","Total",319783,153847,165936,316384,3399,3702,15704.94,20.4
"2011","Wirral","E08000015","Urban (total)",316245,152173,164072,312940,3305,3639,12121.29,26.1
"2011","Wirral","E08000015","Urban major conurbation",313774,150976,162798,310482,3292,3556,11704.76,26.8
"2011","Wirral","E08000015","Urban minor conurbation",0,0,0,0,0,0,0.00,
"2011","Wirral","E08000015","Urban city and town",2471,1197,1274,2458,13,83,416.53,5.9
"2011","Wirral","E08000015","Urban city and town in a sparse setting",0,0,0,0,0,0,0.00,
"2011","Wirral","E08000015","Rural (total)",3538,1674,1864,3444,94,63,3583.65,1.0
"2011","Wirral","E08000015","Rural town and fringe",724,318,406,724,0,2,39.34,18.4
"2011","Wirral","E08000015","Rural town and fringe in a sparse setting",0,0,0,0,0,0,0.00,
"2011","Wirral","E08000015","Rural village",1110,518,592,1032,78,15,1298.86,0.9
"2011","Wirral","E08000015","Rural village in a sparse setting",0,0,0,0,0,0,0.00,
"2011","Wirral","E08000015","Rural hamlet and isolated dwellings",1704,838,866,1688,16,46,2245.45,0.8
"2011","Wirral","E08000015","Rural hamlet and isolated dwellings in a sparse setting",0,0,0,0,0,0,0.00,
"2011","East Riding of Yorkshire","E06000011","Total",334179,163388,170791,326951,7228,4469,240767.65,1.4
"2011","East Riding of Yorkshire","E06000011","Urban (total)",187505,90597,96908,183405,4100,2348,15694.94,11.9
"2011","East Riding of Yorkshire","E06000011","Urban major conurbation",0,0,0,0,0,0,0.00,
"2011","East Riding of Yorkshire","E06000011","Urban minor conurbation",0,0,0,0,0,0,0.00,
"2011","East Riding of Yorkshire","E06000011","Urban city and town",187505,90597,96908,183405,4100,2348,15694.94,11.9
"2011","East Riding of Yorkshire","E06000011","Urban city and town in a sparse setting",0,0,0,0,0,0,0.00,
"2011","East Riding of Yorkshire","E06000011","Rural (total)",146674,72791,73883,143546,3128,2121,225072.71,0.7
"2011","East Riding of Yorkshire","E06000011","Rural town and fringe",81176,39541,41635,80242,934,1059,22439.64,3.6
"2011","East Riding of Yorkshire","E06000011","Rural town and fringe in a sparse setting",0,0,0,0,0,0,0.00,
"2011","East Riding of Yorkshire","E06000011","Rural village",50108,25164,24944,48809,1299,794,109755.85,0.5
"2011","East Riding of Yorkshire","E06000011","Rural village in a sparse setting",0,0,0,0,0,0,0.00,
"2011","East Riding of Yorkshire","E06000011","Rural hamlet and isolated dwellings",15390,8086,7304,14495,895,268,92877.22,0.2
"2011","East Riding of Yorkshire","E06000011","Rural hamlet and isolated dwellings in a sparse setting",0,0,0,0,0,0,0.00,
"2011","Kingston upon Hull, City of","E06000010","Total",256406,128420,127986,252748,3658,1488,7144.92,35.9
"2011","Kingston upon Hull, City of","E06000010","Urban (total)",256406,128420,127986,252748,3658,1488,7144.92,35.9
"2011","Kingston upon Hull, City of","E06000010","Urban major conurbation",0,0,0,0,0,0,0.00,
"2011","Kingston upon Hull, City of","E06000010","Urban minor conurbation",0,0,0,0,0,0,0.00,
"2011","Kingston upon Hull, City of","E06000010","Urban city and town",256406,128420,127986,252748,3658,1488,7144.92,35.9
"2011","Kingston upon Hull, City of","E06000010","Urban city and town in a sparse setting",0,0,0,0,0,0,0.00,
"2011","Kingston upon Hull, City of","E06000010","Rural (total)",0,0,0,0,0,0,0.00,
"2011","Kingston upon Hull, City of","E06000010","Rural town and fringe",0,0,0,0,0,0,0.00,
"2011","Kingston upon Hull, City of","E06000010","Rural town and fringe in a sparse setting",0,0,0,0,0,0,0.00,
"2011","Kingston upon Hull, City of","E06000010","Rural village",0,0,0,0,0,0,0.00,
"2011","Kingston upon Hull, City of","E06000010","Rural village in a sparse setting",0,0,0,0,0,0,0.00,
"2011","Kingston upon Hull, City of","E06000010","Rural hamlet and isolated dwellings",0,0,0,0,0,0,0.00,
"2011","Kingston upon Hull, City of","E06000010","Rural hamlet and isolated dwellings in a sparse setting",0,0,0,0,0,0,0.00,
"2011","North East Lincolnshire","E06000012","Total",159616,78247,81369,157786,1830,1387,19184.49,8.3
"2011","North East Lincolnshire","E06000012","Urban (total)",143802,70514,73288,142245,1557,1125,6850.88,21.0
"2011","North East Lincolnshire","E06000012","Urban major conurbation",0,0,0,0,0,0,0.00,
"2011","North East Lincolnshire","E06000012","Urban minor conurbation",0,0,0,0,0,0,0.00,
"2011","North East Lincolnshire","E06000012","Urban city and town",143802,70514,73288,142245,1557,1125,6850.88,21.0
"2011","North East Lincolnshire","E06000012","Urban city and town in a sparse setting",0,0,0,0,0,0,0.00,
"2011","North East Lincolnshire","E06000012","Rural (total)",15814,7733,8081,15541,273,262,12333.61,1.3
"2011","North East Lincolnshire","E06000012","Rural town and fringe",11171,5499,5672,11087,84,181,1283.02,8.7
"2011","North East Lincolnshire","E06000012","Rural town and fringe in a sparse setting",0,0,0,0,0,0,0.00,
"2011","North East Lincolnshire","E06000012","Rural village",2975,1455,1520,2935,40,58,5338.57,0.6
"2011","North East Lincolnshire","E06000012","Rural village in a sparse setting",0,0,0,0,0,0,0.00,
"2011","North East Lincolnshire","E06000012","Rural hamlet and isolated dwellings",1668,779,889,1519,149,23,5712.02,0.3
"2011","North East Lincolnshire","E06000012","Rural hamlet and isolated dwellings in a sparse setting",0,0,0,0,0,0,0.00,
"2011","North Lincolnshire","E06000013","Total",167446,82623,84823,165871,1575,1777,84631.29,2.0
"2011","North Lincolnshire","E06000013","Urban (total)",92151,45465,46686,91375,776,781,9056.43,10.2
"2011","North Lincolnshire","E06000013","Urban major conurbation",0,0,0,0,0,0,0.00,
"2011","North Lincolnshire","E06000013","Urban minor conurbation",0,0,0,0,0,0,0.00,
"2011","North Lincolnshire","E06000013","Urban city and town",92151,45465,46686,91375,776,781,9056.43,10.2
"2011","North Lincolnshire","E06000013","Urban city and town in a sparse setting",0,0,0,0,0,0,0.00,
"2011","North Lincolnshire","E06000013","Rural (total)",75295,37158,38137,74496,799,996,75574.86,1.0
"2011","North Lincolnshire","E06000013","Rural town and fringe",48350,23728,24622,48011,339,592,9422.90,5.1
"2011","North Lincolnshire","E06000013","Rural town and fringe in a sparse setting",0,0,0,0,0,0,0.00,
"2011","North Lincolnshire","E06000013","Rural village",19672,9835,9837,19385,287,277,36431.85,0.5
"2011","North Lincolnshire","E06000013","Rural village in a sparse setting",0,0,0,0,0,0,0.00,
"2011","North Lincolnshire","E06000013","Rural hamlet and isolated dwellings",7273,3595,3678,7100,173,127,29720.11,0.2
"2011","North Lincolnshire","E06000013","Rural hamlet and isolated dwellings in a sparse setting",0,0,0,0,0,0,0.00,
"2011","York","E06000014","Total",198051,96254,101797,190392,7659,2638,27193.63,7.3
"2011","York","E06000014","Urban (total)",165611,80598,85013,159124,6487,1921,8055.59,20.6
"2011","York","E06000014","Urban major conurbation",0,0,0,0,0,0,0.00,
"2011","York","E06000014","Urban minor conurbation",0,0,0,0,0,0,0.00,
"2011","York","E06000014","Urban city and town",165611,80598,85013,159124,6487,1921,8055.59,20.6
"2011","York","E06000014","Urban city and town in a sparse setting",0,0,0,0,0,0,0.00,
"2011","York","E06000014","Rural (total)",32440,15656,16784,31268,1172,717,19138.04,1.7
"2011","York","E06000014","Rural town and fringe",23880,11533,12347,23132,748,535,4519.89,5.3
"2011","York","E06000014","Rural town and fringe in a sparse setting",0,0,0,0,0,0,0.00,
"2011","York","E06000014","Rural village",6159,2957,3202,5806,353,120,7527.14,0.8
"2011","York","E06000014","Rural village in a sparse setting",0,0,0,0,0,0,0.00,
"2011","York","E06000014","Rural hamlet and isolated dwellings",2401,1166,1235,2330,71,62,7091.01,0.3
"2011","York","E06000014","Rural hamlet and isolated dwellings in a sparse setting",0,0,0,0,0,0,0.00,
"2011","North Yorkshire","E10000023","Total",598376,294110,304266,582624,15752,9956,803761.29,0.7
"2011","North Yorkshire","E10000023","Urban (total)",270559,132953,137606,261405,9154,3640,25328.51,10.7
"2011","North Yorkshire","E10000023","Urban major conurbation",338,170,168,338,0,1,789.81,0.4
"2011","North Yorkshire","E10000023","Urban minor conurbation",0,0,0,0,0,0,0.00,
"2011","North Yorkshire","E10000023","Urban city and town",257008,126364,130644,248192,8816,3489,23589.75,10.9
"2011","North Yorkshire","E10000023","Urban city and town in a sparse setting",13213,6419,6794,12875,338,150,948.95,13.9
"2011","North Yorkshire","E10000023","Rural (total)",327817,161157,166660,321219,6598,6316,778432.78,0.4
"2011","North Yorkshire","E10000023","Rural town and fringe",100167,48803,51364,98306,1861,1550,21321.85,4.7
"2011","North Yorkshire","E10000023","Rural town and fringe in a sparse setting",32311,15390,16921,31783,528,425,12899.89,2.5
"2011","North Yorkshire","E10000023","Rural village",101997,50269,51728,99843,2154,2127,175982.00,0.6
"2011","North Yorkshire","E10000023","Rural village in a sparse setting",23101,11304,11797,22791,310,467,86948.50,0.3
"2011","North Yorkshire","E10000023","Rural hamlet and isolated dwellings",55466,27960,27506,53864,1602,1402,309558.75,0.2
"2011","North Yorkshire","E10000023","Rural hamlet and isolated dwellings in a sparse setting",14775,7431,7344,14632,143,345,171721.79,0.1
"2011","Barnsley","E08000016","Total",231221,113634,117587,229539,1682,1681,32905.31,7.0
"2011","Barnsley","E08000016","Urban (total)",207048,101757,105291,205566,1482,1441,14840.88,14.0
"2011","Barnsley","E08000016","Urban major conurbation",0,0,0,0,0,0,0.00,
"2011","Barnsley","E08000016","Urban minor conurbation",184804,90805,93999,183356,1448,1192,11203.80,16.5
"2011","Barnsley","E08000016","Urban city and town",22244,10952,11292,22210,34,249,3637.08,6.1
"2011","Barnsley","E08000016","Urban city and town in a sparse setting",0,0,0,0,0,0,0.00,
"2011","Barnsley","E08000016","Rural (total)",24173,11877,12296,23973,200,240,18064.43,1.3
"2011","Barnsley","E08000016","Rural town and fringe",14567,7108,7459,14401,166,120,2451.19,5.9
"2011","Barnsley","E08000016","Rural town and fringe in a sparse setting",0,0,0,0,0,0,0.00,
"2011","Barnsley","E08000016","Rural village",5874,2889,2985,5864,10,76,5019.00,1.2
"2011","Barnsley","E08000016","Rural village in a sparse setting",0,0,0,0,0,0,0.00,
"2011","Barnsley","E08000016","Rural hamlet and isolated dwellings",3732,1880,1852,3708,24,44,10594.24,0.4
"2011","Barnsley","E08000016","Rural hamlet and isolated dwellings in a sparse setting",0,0,0,0,0,0,0.00,
"2011","Doncaster","E08000017","Total",302402,149230,153172,297200,5202,2764,56799.22,5.3
"2011","Doncaster","E08000017","Urban (total)",260240,127661,132579,257335,2905,2218,21498.14,12.1
"2011","Doncaster","E08000017","Urban major conurbation",0,0,0,0,0,0,0.00,
"2011","Doncaster","E08000017","Urban minor conurbation",215009,105670,109339,212484,2525,1853,12331.40,17.4
"2011","Doncaster","E08000017","Urban city and town",45231,21991,23240,44851,380,365,9166.74,4.9
"2011","Doncaster","E08000017","Urban city and town in a sparse setting",0,0,0,0,0,0,0.00,
"2011","Doncaster","E08000017","Rural (total)",42162,21569,20593,39865,2297,546,35301.08,1.2
"2011","Doncaster","E08000017","Rural town and fringe",27064,13074,13990,26953,111,331,4313.14,6.3
"2011","Doncaster","E08000017","Rural town and fringe in a sparse setting",0,0,0,0,0,0,0.00,
"2011","Doncaster","E08000017","Rural village",10257,5950,4307,8391,1866,130,15982.41,0.6
"2011","Doncaster","E08000017","Rural village in a sparse setting",0,0,0,0,0,0,0.00,
"2011","Doncaster","E08000017","Rural hamlet and isolated dwellings",4841,2545,2296,4521,320,85,15005.53,0.3
"2011","Doncaster","E08000017","Rural hamlet and isolated dwellings in a sparse setting",0,0,0,0,0,0,0.00,
"2011","Rotherham","E08000018","Total",257280,126247,131033,255334,1946,2178,28653.77,9.0
"2011","Rotherham","E08000018","Urban (total)",231177,113528,117649,229373,1804,1906,14182.92,16.3
"2011","Rotherham","E08000018","Urban major conurbation",0,0,0,0,0,0,0.00,
"2011","Rotherham","E08000018","Urban minor conurbation",185796,91171,94625,184282,1514,1471,10065.22,18.5
"2011","Rotherham","E08000018","Urban city and town",45381,22357,23024,45091,290,435,4117.70,11.0
"2011","Rotherham","E08000018","Urban city and town in a sparse setting",0,0,0,0,0,0,0.00,
"2011","Rotherham","E08000018","Rural (total)",26103,12719,13384,25961,142,272,14470.85,1.8
"2011","Rotherham","E08000018","Rural town and fringe",20435,9963,10472,20349,86,203,3363.76,6.1
"2011","Rotherham","E08000018","Rural town and fringe in a sparse setting",0,0,0,0,0,0,0.00,
"2011","Rotherham","E08000018","Rural village",3893,1892,2001,3839,54,39,5336.54,0.7
"2011","Rotherham","E08000018","Rural village in a sparse setting",0,0,0,0,0,0,0.00,
"2011","Rotherham","E08000018","Rural hamlet and isolated dwellings",1775,864,911,1773,2,30,5770.55,0.3
"2011","Rotherham","E08000018","Rural hamlet and isolated dwellings in a sparse setting",0,0,0,0,0,0,0.00,
"2011","Sheffield","E08000019","Total",552698,272661,280037,539064,13634,5017,36794.79,15.0
"2011","Sheffield","E08000019","Urban (total)",543008,267883,275125,529439,13569,4893,18496.64,29.4
"2011","Sheffield","E08000019","Urban major conurbation",0,0,0,0,0,0,0.00,
"2011","Sheffield","E08000019","Urban minor conurbation",525842,259429,266413,512500,13342,4708,16517.65,31.8
"2011","Sheffield","E08000019","Urban city and town",17166,8454,8712,16939,227,185,1978.99,8.7
"2011","Sheffield","E08000019","Urban city and town in a sparse setting",0,0,0,0,0,0,0.00,
"2011","Sheffield","E08000019","Rural (total)",9690,4778,4912,9625,65,124,18298.15,0.5
"2011","Sheffield","E08000019","Rural town and fringe",6060,2977,3083,6040,20,73,604.63,10.0
"2011","Sheffield","E08000019","Rural town and fringe in a sparse setting",0,0,0,0,0,0,0.00,
"2011","Sheffield","E08000019","Rural village",1630,813,817,1630,0,18,1741.68,0.9
"2011","Sheffield","E08000019","Rural village in a sparse setting",0,0,0,0,0,0,0.00,
"2011","Sheffield","E08000019","Rural hamlet and isolated dwellings",2000,988,1012,1955,45,33,15951.84,0.1
"2011","Sheffield","E08000019","Rural hamlet and isolated dwellings in a sparse setting",0,0,0,0,0,0,0.00,
"2011","Bradford","E08000032","Total",522452,257132,265320,515315,7137,4896,36641.72,14.3
"2011","Bradford","E08000032","Urban (total)",486624,239981,246643,480220,6404,4370,18941.22,25.7
"2011","Bradford","E08000032","Urban major conurbation",398239,197007,201232,392854,5385,3255,11455.85,34.8
"2011","Bradford","E08000032","Urban minor conurbation",0,0,0,0,0,0,0.00,
"2011","Bradford","E08000032","Urban city and town",88385,42974,45411,87366,1019,1115,7485.37,11.8
"2011","Bradford","E08000032","Urban city and town in a sparse setting",0,0,0,0,0,0,0.00,
"2011","Bradford","E08000032","Rural (total)",35828,17151,18677,35095,733,526,17700.50,2.0
"2011","Bradford","E08000032","Rural town and fringe",26924,12661,14263,26279,645,382,2277.90,11.8
"2011","Bradford","E08000032","Rural town and fringe in a sparse setting",0,0,0,0,0,0,0.00,
"2011","Bradford","E08000032","Rural village",1131,572,559,1131,0,11,1199.90,0.9
"2011","Bradford","E08000032","Rural village in a sparse setting",0,0,0,0,0,0,0.00,
"2011","Bradford","E08000032","Rural hamlet and isolated dwellings",7773,3918,3855,7685,88,133,14222.70,0.5
"2011","Bradford","E08000032","Rural hamlet and isolated dwellings in a sparse setting",0,0,0,0,0,0,0.00,
"2011","Calderdale","E08000033","Total",203826,99627,104199,202376,1450,2168,36392.21,5.6
"2011","Calderdale","E08000033","Urban (total)",164600,80499,84101,163280,1320,1567,8276.20,19.9
"2011","Calderdale","E08000033","Urban major conurbation",148908,72941,75967,147784,1124,1382,6698.72,22.2
"2011","Calderdale","E08000033","Urban minor conurbation",0,0,0,0,0,0,0.00,
"2011","Calderdale","E08000033","Urban city and town",15692,7558,8134,15496,196,185,1577.48,9.9
"2011","Calderdale","E08000033","Urban city and town in a sparse setting",0,0,0,0,0,0,0.00,
"2011","Calderdale","E08000033","Rural (total)",39226,19128,20098,39096,130,601,28116.01,1.4
"2011","Calderdale","E08000033","Rural town and fringe",20266,9710,10556,20166,100,261,1712.65,11.8
"2011","Calderdale","E08000033","Rural town and fringe in a sparse setting",0,0,0,0,0,0,0.00,
"2011","Calderdale","E08000033","Rural village",7292,3612,3680,7280,12,132,3937.60,1.9
"2011","Calderdale","E08000033","Rural village in a sparse setting",0,0,0,0,0,0,0.00,
"2011","Calderdale","E08000033","Rural hamlet and isolated dwellings",11668,5806,5862,11650,18,208,22465.76,0.5
"2011","Calderdale","E08000033","Rural hamlet and isolated dwellings in a sparse setting",0,0,0,0,0,0,0.00,
"2011","Kirklees","E08000034","Total",422458,208657,213801,416840,5618,4014,40859.65,10.3
"2011","Kirklees","E08000034","Urban (total)",373540,184576,188964,369389,4151,3255,17980.91,20.8
"2011","Kirklees","E08000034","Urban major conurbation",351616,173845,177771,347604,4012,2949,15073.43,23.3
"2011","Kirklees","E08000034","Urban minor conurbation",0,0,0,0,0,0,0.00,
"2011","Kirklees","E08000034","Urban city and town",21924,10731,11193,21785,139,306,2907.48,7.5
"2011","Kirklees","E08000034","Urban city and town in a sparse setting",0,0,0,0,0,0,0.00,
"2011","Kirklees","E08000034","Rural (total)",48918,24081,24837,47451,1467,759,22878.74,2.1
"2011","Kirklees","E08000034","Rural town and fringe",33271,16279,16992,33075,196,472,7447.32,4.5
"2011","Kirklees","E08000034","Rural town and fringe in a sparse setting",0,0,0,0,0,0,0.00,
"2011","Kirklees","E08000034","Rural village",8983,4454,4529,7822,1161,170,7491.62,1.2
"2011","Kirklees","E08000034","Rural village in a sparse setting",0,0,0,0,0,0,0.00,
"2011","Kirklees","E08000034","Rural hamlet and isolated dwellings",6664,3348,3316,6554,110,117,7939.80,0.8
"2011","Kirklees","E08000034","Rural hamlet and isolated dwellings in a sparse setting",0,0,0,0,0,0,0.00,
"2011","Leeds","E08000035","Total",751485,367935,383550,731373,20112,7700,55172.44,13.6
"2011","Leeds","E08000035","Urban (total)",708450,346575,361875,689296,19154,6963,32990.47,21.5
"2011","Leeds","E08000035","Urban major conurbation",656134,321274,334860,637599,18535,6314,25834.41,25.4
"2011","Leeds","E08000035","Urban minor conurbation",0,0,0,0,0,0,0.00,
"2011","Leeds","E08000035","Urban city and town",52316,25301,27015,51697,619,649,7156.06,7.3
"2011","Leeds","E08000035","Urban city and town in a sparse setting",0,0,0,0,0,0,0.00,
"2011","Leeds","E08000035","Rural (total)",43035,21360,21675,42077,958,737,22181.97,1.9
"2011","Leeds","E08000035","Rural town and fringe",30197,14564,15633,30056,141,485,4813.43,6.3
"2011","Leeds","E08000035","Rural town and fringe in a sparse setting",0,0,0,0,0,0,0.00,
"2011","Leeds","E08000035","Rural village",9115,4909,4206,8301,814,186,9988.27,0.9
"2011","Leeds","E08000035","Rural village in a sparse setting",0,0,0,0,0,0,0.00,
"2011","Leeds","E08000035","Rural hamlet and isolated dwellings",3723,1887,1836,3720,3,66,7380.27,0.5
"2011","Leeds","E08000035","Rural hamlet and isolated dwellings in a sparse setting",0,0,0,0,0,0,0.00,
"2011","Wakefield","E08000036","Total",325837,159913,165924,322264,3573,2843,33861.24,9.6
"2011","Wakefield","E08000036","Urban (total)",268009,131728,136281,265139,2870,2297,16942.83,15.8
"2011","Wakefield","E08000036","Urban major conurbation",129269,63823,65446,127452,1817,1257,6990.41,18.5
"2011","Wakefield","E08000036","Urban minor conurbation",0,0,0,0,0,0,0.00,
"2011","Wakefield","E08000036","Urban city and town",138740,67905,70835,137687,1053,1040,9952.42,13.9
"2011","Wakefield","E08000036","Urban city and town in a sparse setting",0,0,0,0,0,0,0.00,
"2011","Wakefield","E08000036","Rural (total)",57828,28185,29643,57125,703,546,16918.41,3.4
"2011","Wakefield","E08000036","Rural town and fringe",44793,21957,22836,44455,338,325,5271.89,8.5
"2011","Wakefield","E08000036","Rural town and fringe in a sparse setting",0,0,0,0,0,0,0.00,
"2011","Wakefield","E08000036","Rural village",10504,5132,5372,10475,29,192,7126.66,1.5
"2011","Wakefield","E08000036","Rural village in a sparse setting",0,0,0,0,0,0,0.00,
"2011","Wakefield","E08000036","Rural hamlet and isolated dwellings",2531,1096,1435,2195,336,29,4519.86,0.6
"2011","Wakefield","E08000036","Rural hamlet and isolated dwellings in a sparse setting",0,0,0,0,0,0,0.00,
"2011","Derby","E06000015","Total",248752,123046,125706,244625,4127,2431,7803.11,31.9
"2011","Derby","E06000015","Urban (total)",248752,123046,125706,244625,4127,2431,7803.11,31.9
"2011","Derby","E06000015","Urban major conurbation",0,0,0,0,0,0,0.00,
"2011","Derby","E06000015","Urban minor conurbation",0,0,0,0,0,0,0.00,
"2011","Derby","E06000015","Urban city and town",248752,123046,125706,244625,4127,2431,7803.11,31.9
"2011","Derby","E06000015","Urban city and town in a sparse setting",0,0,0,0,0,0,0.00,
"2011","Derby","E06000015","Rural (total)",0,0,0,0,0,0,0.00,
"2011","Derby","E06000015","Rural town and fringe",0,0,0,0,0,0,0.00,
"2011","Derby","E06000015","Rural town and fringe in a sparse setting",0,0,0,0,0,0,0.00,
"2011","Derby","E06000015","Rural village",0,0,0,0,0,0,0.00,
"2011","Derby","E06000015","Rural village in a sparse setting",0,0,0,0,0,0,0.00,
"2011","Derby","E06000015","Rural hamlet and isolated dwellings",0,0,0,0,0,0,0.00,
"2011","Derby","E06000015","Rural hamlet and isolated dwellings in a sparse setting",0,0,0,0,0,0,0.00,
"2011","Leicester","E06000016","Total",329839,162884,166955,321527,8312,3332,7331.48,45.0
"2011","Leicester","E06000016","Urban (total)",329283,162614,166669,320971,8312,3313,7107.14,46.3
"2011","Leicester","E06000016","Urban major conurbation",0,0,0,0,0,0,0.00,
"2011","Leicester","E06000016","Urban minor conurbation",0,0,0,0,0,0,0.00,
"2011","Leicester","E06000016","Urban city and town",329283,162614,166669,320971,8312,3313,7107.14,46.3
"2011","Leicester","E06000016","Urban city and town in a sparse setting",0,0,0,0,0,0,0.00,
"2011","Leicester","E06000016","Rural (total)",556,270,286,556,0,19,224.34,2.5
"2011","Leicester","E06000016","Rural town and fringe",0,0,0,0,0,0,0.00,
"2011","Leicester","E06000016","Rural town and fringe in a sparse setting",0,0,0,0,0,0,0.00,
"2011","Leicester","E06000016","Rural village",0,0,0,0,0,0,0.00,
"2011","Leicester","E06000016","Rural village in a sparse setting",0,0,0,0,0,0,0.00,
"2011","Leicester","E06000016","Rural hamlet and isolated dwellings",556,270,286,556,0,19,224.34,2.5
"2011","Leicester","E06000016","Rural hamlet and isolated dwellings in a sparse setting",0,0,0,0,0,0,0.00,
"2011","Nottingham","E06000018","Total",305680,153777,151903,289738,15942,2556,7461.16,41.0
"2011","Nottingham","E06000018","Urban (total)",305680,153777,151903,289738,15942,2556,7461.16,41.0
"2011","Nottingham","E06000018","Urban major conurbation",0,0,0,0,0,0,0.00,
"2011","Nottingham","E06000018","Urban minor conurbation",305680,153777,151903,289738,15942,2556,7461.16,41.0
"2011","Nottingham","E06000018","Urban city and town",0,0,0,0,0,0,0.00,
"2011","Nottingham","E06000018","Urban city and town in a sparse setting",0,0,0,0,0,0,0.00,
"2011","Nottingham","E06000018","Rural (total)",0,0,0,0,0,0,0.00,
"2011","Nottingham","E06000018","Rural town and fringe",0,0,0,0,0,0,0.00,
"2011","Nottingham","E06000018","Rural town and fringe in a sparse setting",0,0,0,0,0,0,0.00,
"2011","Nottingham","E06000018","Rural village",0,0,0,0,0,0,0.00,
"2011","Nottingham","E06000018","Rural village in a sparse setting",0,0,0,0,0,0,0.00,
"2011","Nottingham","E06000018","Rural hamlet and isolated dwellings",0,0,0,0,0,0,0.00,
"2011","Nottingham","E06000018","Rural hamlet and isolated dwellings in a sparse setting",0,0,0,0,0,0,0.00,
"2011","Rutland","E06000017","Total",37369,18915,18454,34252,3117,842,38151.51,1.0
"2011","Rutland","E06000017","Urban (total)",11522,5588,5934,10979,543,217,2365.39,4.9
"2011","Rutland","E06000017","Urban major conurbation",0,0,0,0,0,0,0.00,
"2011","Rutland","E06000017","Urban minor conurbation",0,0,0,0,0,0,0.00,
"2011","Rutland","E06000017","Urban city and town",11522,5588,5934,10979,543,217,2365.39,4.9
"2011","Rutland","E06000017","Urban city and town in a sparse setting",0,0,0,0,0,0,0.00,
"2011","Rutland","E06000017","Rural (total)",25847,13327,12520,23273,2574,625,35786.12,0.7
"2011","Rutland","E06000017","Rural town and fringe",9181,4563,4618,8154,1027,194,3649.85,2.5
"2011","Rutland","E06000017","Rural town and fringe in a sparse setting",0,0,0,0,0,0,0.00,
"2011","Rutland","E06000017","Rural village",16038,8461,7577,14506,1532,420,30433.18,0.5
"2011","Rutland","E06000017","Rural village in a sparse setting",0,0,0,0,0,0,0.00,
"2011","Rutland","E06000017","Rural hamlet and isolated dwellings",628,303,325,613,15,11,1703.09,0.4
"2011","Rutland","E06000017","Rural hamlet and isolated dwellings in a sparse setting",0,0,0,0,0,0,0.00,
"2011","Derbyshire","E10000007","Total",769686,378786,390900,760840,8846,8700,254669.96,3.0
"2011","Derbyshire","E10000007","Urban (total)",561502,275867,285635,556145,5357,5561,52962.21,10.6
"2011","Derbyshire","E10000007","Urban major conurbation",31080,15234,15846,30848,232,403,1428.13,21.8
"2011","Derbyshire","E10000007","Urban minor conurbation",207595,102083,105512,205784,1811,1641,13011.49,16.0
"2011","Derbyshire","E10000007","Urban city and town",322827,158550,164277,319513,3314,3517,38522.59,8.4
"2011","Derbyshire","E10000007","Urban city and town in a sparse setting",0,0,0,0,0,0,0.00,
"2011","Derbyshire","E10000007","Rural (total)",208184,102919,105265,204695,3489,3139,201707.75,1.0
"2011","Derbyshire","E10000007","Rural town and fringe",112290,55136,57154,110690,1600,1400,18887.55,5.9
"2011","Derbyshire","E10000007","Rural town and fringe in a sparse setting",0,0,0,0,0,0,0.00,
"2011","Derbyshire","E10000007","Rural village",64908,32268,32640,63931,977,1155,72348.24,0.9
"2011","Derbyshire","E10000007","Rural village in a sparse setting",0,0,0,0,0,0,0.00,
"2011","Derbyshire","E10000007","Rural hamlet and isolated dwellings",30986,15515,15471,30074,912,584,110471.96,0.3
"2011","Derbyshire","E10000007","Rural hamlet and isolated dwellings in a sparse setting",0,0,0,0,0,0,0.00,
"2011","Leicestershire","E10000018","Total",650489,321416,329073,636274,14215,9344,208287.86,3.1
"2011","Leicestershire","E10000018","Urban (total)",451913,223110,228803,440191,11722,5949,36292.73,12.5
"2011","Leicestershire","E10000018","Urban major conurbation",0,0,0,0,0,0,0.00,
"2011","Leicestershire","E10000018","Urban minor conurbation",0,0,0,0,0,0,0.00,
"2011","Leicestershire","E10000018","Urban city and town",451913,223110,228803,440191,11722,5949,36292.73,12.5
"2011","Leicestershire","E10000018","Urban city and town in a sparse setting",0,0,0,0,0,0,0.00,
"2011","Leicestershire","E10000018","Rural (total)",198576,98306,100270,196083,2493,3395,171995.13,1.2
"2011","Leicestershire","E10000018","Rural town and fringe",114901,56346,58555,114232,669,1606,19377.73,5.9
"2011","Leicestershire","E10000018","Rural town and fringe in a sparse setting",0,0,0,0,0,0,0.00,
"2011","Leicestershire","E10000018","Rural village",69471,34467,35004,68649,822,1480,103656.30,0.7
"2011","Leicestershire","E10000018","Rural village in a sparse setting",0,0,0,0,0,0,0.00,
"2011","Leicestershire","E10000018","Rural hamlet and isolated dwellings",14204,7493,6711,13202,1002,309,48961.10,0.3
"2011","Leicestershire","E10000018","Rural hamlet and isolated dwellings in a sparse setting",0,0,0,0,0,0,0.00,
"2011","Lincolnshire","E10000019","Total",713653,347605,366048,698748,14905,9048,592061.92,1.2
"2011","Lincolnshire","E10000019","Urban (total)",370388,179323,191065,360413,9975,4146,31305.38,11.8
"2011","Lincolnshire","E10000019","Urban major conurbation",0,0,0,0,0,0,0.00,
"2011","Lincolnshire","E10000019","Urban minor conurbation",0,0,0,0,0,0,0.00,
"2011","Lincolnshire","E10000019","Urban city and town",358224,173529,184695,348543,9681,4076,28990.12,12.4
"2011","Lincolnshire","E10000019","Urban city and town in a sparse setting",12164,5794,6370,11870,294,70,2315.26,5.3
"2011","Lincolnshire","E10000019","Rural (total)",343265,168282,174983,338335,4930,4902,560756.54,0.6
"2011","Lincolnshire","E10000019","Rural town and fringe",146932,71274,75658,145021,1911,1825,40352.96,3.6
"2011","Lincolnshire","E10000019","Rural town and fringe in a sparse setting",6504,3050,3454,6389,115,46,1389.63,4.7
"2011","Lincolnshire","E10000019","Rural village",120962,59592,61370,119315,1647,2038,216852.64,0.6
"2011","Lincolnshire","E10000019","Rural village in a sparse setting",11359,5613,5746,11246,113,144,20311.00,0.6
"2011","Lincolnshire","E10000019","Rural hamlet and isolated dwellings",49701,24870,24831,48715,986,739,240866.95,0.2
"2011","Lincolnshire","E10000019","Rural hamlet and isolated dwellings in a sparse setting",7807,3883,3924,7649,158,110,40983.36,0.2
"2011","Northamptonshire","E10000021","Total",691952,341342,350610,681850,10102,9222,236397.29,2.9
"2011","Northamptonshire","E10000021","Urban (total)",471327,231670,239657,465347,5980,4967,24234.61,19.4
"2011","Northamptonshire","E10000021","Urban major conurbation",0,0,0,0,0,0,0.00,
"2011","Northamptonshire","E10000021","Urban minor conurbation",0,0,0,0,0,0,0.00,
"2011","Northamptonshire","E10000021","Urban city and town",471327,231670,239657,465347,5980,4967,24234.61,19.4
"2011","Northamptonshire","E10000021","Urban city and town in a sparse setting",0,0,0,0,0,0,0.00,
"2011","Northamptonshire","E10000021","Rural (total)",220625,109672,110953,216503,4122,4255,212162.68,1.0
"2011","Northamptonshire","E10000021","Rural town and fringe",134088,66255,67833,132092,1996,2011,34110.96,3.9
"2011","Northamptonshire","E10000021","Rural town and fringe in a sparse setting",0,0,0,0,0,0,0.00,
"2011","Northamptonshire","E10000021","Rural village",74005,37180,36825,72082,1923,1856,129201.62,0.6
"2011","Northamptonshire","E10000021","Rural village in a sparse setting",0,0,0,0,0,0,0.00,
"2011","Northamptonshire","E10000021","Rural hamlet and isolated dwellings",12532,6237,6295,12329,203,388,48850.10,0.3
"2011","Northamptonshire","E10000021","Rural hamlet and isolated dwellings in a sparse setting",0,0,0,0,0,0,0.00,
"2011","Nottinghamshire","E10000024","Total",785802,386722,399080,774338,11464,8941,208477.38,3.8
"2011","Nottinghamshire","E10000024","Urban (total)",572527,280983,291544,567238,5289,5775,39366.58,14.5
"2011","Nottinghamshire","E10000024","Urban major conurbation",0,0,0,0,0,0,0.00,
"2011","Nottinghamshire","E10000024","Urban minor conurbation",281375,138219,143156,279106,2269,3277,13756.49,20.5
"2011","Nottinghamshire","E10000024","Urban city and town",291152,142764,148388,288132,3020,2498,25610.09,11.4
"2011","Nottinghamshire","E10000024","Urban city and town in a sparse setting",0,0,0,0,0,0,0.00,
"2011","Nottinghamshire","E10000024","Rural (total)",213275,105739,107536,207100,6175,3166,169110.80,1.3
"2011","Nottinghamshire","E10000024","Rural town and fringe",138128,67163,70965,137025,1103,1643,25123.30,5.5
"2011","Nottinghamshire","E10000024","Rural town and fringe in a sparse setting",0,0,0,0,0,0,0.00,
"2011","Nottinghamshire","E10000024","Rural village",57665,29572,28093,54135,3530,1170,84062.97,0.7
"2011","Nottinghamshire","E10000024","Rural village in a sparse setting",0,0,0,0,0,0,0.00,
"2011","Nottinghamshire","E10000024","Rural hamlet and isolated dwellings",17482,9004,8478,15940,1542,353,59924.53,0.3
"2011","Nottinghamshire","E10000024","Rural hamlet and isolated dwellings in a sparse setting",0,0,0,0,0,0,0.00,
"2011","Herefordshire, County of","E06000019","Total",183477,90302,93175,180595,2882,3080,217973.24,0.8
"2011","Herefordshire, County of","E06000019","Urban (total)",84335,41296,43039,83178,1157,1017,5827.73,14.5
"2011","Herefordshire, County of","E06000019","Urban major conurbation",0,0,0,0,0,0,0.00,
"2011","Herefordshire, County of","E06000019","Urban minor conurbation",0,0,0,0,0,0,0.00,
"2011","Herefordshire, County of","E06000019","Urban city and town",82342,40313,42029,81194,1148,1003,5653.99,14.6
"2011","Herefordshire, County of","E06000019","Urban city and town in a sparse setting",1993,983,1010,1984,9,14,173.74,11.5
"2011","Herefordshire, County of","E06000019","Rural (total)",99142,49006,50136,97417,1725,2063,212145.51,0.5
"2011","Herefordshire, County of","E06000019","Rural town and fringe",15437,7507,7930,15074,363,154,2567.44,6.0
"2011","Herefordshire, County of","E06000019","Rural town and fringe in a sparse setting",2427,1132,1295,2370,57,35,231.48,10.5
"2011","Herefordshire, County of","E06000019","Rural village",32874,16243,16631,32396,478,662,39728.04,0.8
"2011","Herefordshire, County of","E06000019","Rural village in a sparse setting",6681,3267,3414,6557,124,137,9818.32,0.7
"2011","Herefordshire, County of","E06000019","Rural hamlet and isolated dwellings",30764,15355,15409,30144,620,772,101269.81,0.3
"2011","Herefordshire, County of","E06000019","Rural hamlet and isolated dwellings in a sparse setting",10959,5502,5457,10876,83,303,58530.42,0.2
"2011","Shropshire","E06000051","Total",306129,151606,154523,298183,7946,4905,319730.32,1.0
"2011","Shropshire","E06000051","Urban (total)",130660,64146,66514,128173,2487,1801,7900.01,16.5
"2011","Shropshire","E06000051","Urban major conurbation",0,0,0,0,0,0,0.00,
"2011","Shropshire","E06000051","Urban minor conurbation",0,0,0,0,0,0,0.00,
"2011","Shropshire","E06000051","Urban city and town",120145,59084,61061,117799,2346,1674,7385.52,16.3
"2011","Shropshire","E06000051","Urban city and town in a sparse setting",10515,5062,5453,10374,141,127,514.49,20.4
"2011","Shropshire","E06000051","Rural (total)",175469,87460,88009,170010,5459,3104,311830.31,0.6
"2011","Shropshire","E06000051","Rural town and fringe",65308,31894,33414,64393,915,881,10700.30,6.1
"2011","Shropshire","E06000051","Rural town and fringe in a sparse setting",4392,2177,2215,4268,124,48,1437.59,3.1
"2011","Shropshire","E06000051","Rural village",42946,21411,21535,41363,1583,767,57716.82,0.7
"2011","Shropshire","E06000051","Rural village in a sparse setting",4619,2280,2339,4617,2,112,9420.74,0.5
"2011","Shropshire","E06000051","Rural hamlet and isolated dwellings",49423,25241,24182,46784,2639,1120,173054.54,0.3
"2011","Shropshire","E06000051","Rural hamlet and isolated dwellings in a sparse setting",8781,4457,4324,8585,196,176,59500.32,0.1
"2011","Stoke-on-Trent","E06000021","Total",249008,123995,125013,246075,2933,1545,9345.02,26.6
"2011","Stoke-on-Trent","E06000021","Urban (total)",248337,123662,124675,245450,2887,1543,9089.23,27.3
"2011","Stoke-on-Trent","E06000021","Urban major conurbation",0,0,0,0,0,0,0.00,
"2011","Stoke-on-Trent","E06000021","Urban minor conurbation",0,0,0,0,0,0,0.00,
"2011","Stoke-on-Trent","E06000021","Urban city and town",248337,123662,124675,245450,2887,1543,9089.23,27.3
"2011","Stoke-on-Trent","E06000021","Urban city and town in a sparse setting",0,0,0,0,0,0,0.00,
"2011","Stoke-on-Trent","E06000021","Rural (total)",671,333,338,625,46,2,255.79,2.6
"2011","Stoke-on-Trent","E06000021","Rural town and fringe",0,0,0,0,0,0,0.00,
"2011","Stoke-on-Trent","E06000021","Rural town and fringe in a sparse setting",0,0,0,0,0,0,0.00,
"2011","Stoke-on-Trent","E06000021","Rural village",483,232,251,449,34,1,108.90,4.4
"2011","Stoke-on-Trent","E06000021","Rural village in a sparse setting",0,0,0,0,0,0,0.00,
"2011","Stoke-on-Trent","E06000021","Rural hamlet and isolated dwellings",188,101,87,176,12,1,146.89,1.3
"2011","Stoke-on-Trent","E06000021","Rural hamlet and isolated dwellings in a sparse setting",0,0,0,0,0,0,0.00,
"2011","Telford and Wrekin","E06000020","Total",166641,82549,84092,164440,2201,1813,29031.32,5.7
"2011","Telford and Wrekin","E06000020","Urban (total)",155464,76950,78514,154213,1251,1582,9771.48,15.9
"2011","Telford and Wrekin","E06000020","Urban major conurbation",0,0,0,0,0,0,0.00,
"2011","Telford and Wrekin","E06000020","Urban minor conurbation",0,0,0,0,0,0,0.00,
"2011","Telford and Wrekin","E06000020","Urban city and town",155464,76950,78514,154213,1251,1582,9771.48,15.9
"2011","Telford and Wrekin","E06000020","Urban city and town in a sparse setting",0,0,0,0,0,0,0.00,
"2011","Telford and Wrekin","E06000020","Rural (total)",11177,5599,5578,10227,950,231,19259.84,0.6
"2011","Telford and Wrekin","E06000020","Rural town and fringe",632,318,314,628,4,10,94.18,6.7
"2011","Telford and Wrekin","E06000020","Rural town and fringe in a sparse setting",0,0,0,0,0,0,0.00,
"2011","Telford and Wrekin","E06000020","Rural village",5793,2896,2897,5767,26,108,6587.21,0.9
"2011","Telford and Wrekin","E06000020","Rural village in a sparse setting",0,0,0,0,0,0,0.00,
"2011","Telford and Wrekin","E06000020","Rural hamlet and isolated dwellings",4752,2385,2367,3832,920,113,12578.45,0.4
"2011","Telford and Wrekin","E06000020","Rural hamlet and isolated dwellings in a sparse setting",0,0,0,0,0,0,0.00,
"2011","Staffordshire","E10000028","Total",848489,419918,428571,832952,15537,9941,262027.95,3.2
"2011","Staffordshire","E10000028","Urban (total)",642633,317459,325174,635681,6952,6624,42810.51,15.0
"2011","Staffordshire","E10000028","Urban major conurbation",154961,76319,78642,153949,1012,1557,10407.41,14.9
"2011","Staffordshire","E10000028","Urban minor conurbation",0,0,0,0,0,0,0.00,
"2011","Staffordshire","E10000028","Urban city and town",487672,241140,246532,481732,5940,5067,32403.10,15.1
"2011","Staffordshire","E10000028","Urban city and town in a sparse setting",0,0,0,0,0,0,0.00,
"2011","Staffordshire","E10000028","Rural (total)",205856,102459,103397,197271,8585,3317,219217.44,0.9
"2011","Staffordshire","E10000028","Rural town and fringe",94813,46294,48519,94393,420,1312,12517.63,7.6
"2011","Staffordshire","E10000028","Rural town and fringe in a sparse setting",0,0,0,0,0,0,0.00,
"2011","Staffordshire","E10000028","Rural village",63277,31514,31763,58170,5107,1091,54687.08,1.2
"2011","Staffordshire","E10000028","Rural village in a sparse setting",0,0,0,0,0,0,0.00,
"2011","Staffordshire","E10000028","Rural hamlet and isolated dwellings",47766,24651,23115,44708,3058,914,152012.73,0.3
"2011","Staffordshire","E10000028","Rural hamlet and isolated dwellings in a sparse setting",0,0,0,0,0,0,0.00,
"2011","Warwickshire","E10000031","Total",545474,269076,276398,537501,7973,7829,197508.17,2.8
"2011","Warwickshire","E10000031","Urban (total)",365377,180592,184785,359641,5736,4601,25042.17,14.6
"2011","Warwickshire","E10000031","Urban major conurbation",0,0,0,0,0,0,0.00,
"2011","Warwickshire","E10000031","Urban minor conurbation",0,0,0,0,0,0,0.00,
"2011","Warwickshire","E10000031","Urban city and town",365377,180592,184785,359641,5736,4601,25042.17,14.6
"2011","Warwickshire","E10000031","Urban city and town in a sparse setting",0,0,0,0,0,0,0.00,
"2011","Warwickshire","E10000031","Rural (total)",180097,88484,91613,177860,2237,3228,172466.00,1.0
"2011","Warwickshire","E10000031","Rural town and fringe",92589,45108,47481,91778,811,1222,13541.30,6.8
"2011","Warwickshire","E10000031","Rural town and fringe in a sparse setting",0,0,0,0,0,0,0.00,
"2011","Warwickshire","E10000031","Rural village",60642,29963,30679,59716,926,1270,72535.49,0.8
"2011","Warwickshire","E10000031","Rural village in a sparse setting",0,0,0,0,0,0,0.00,
"2011","Warwickshire","E10000031","Rural hamlet and isolated dwellings",26866,13413,13453,26366,500,736,86389.21,0.3
"2011","Warwickshire","E10000031","Rural hamlet and isolated dwellings in a sparse setting",0,0,0,0,0,0,0.00,
"2011","Birmingham","E08000025","Total",1073045,527806,545239,1051366,21679,9438,26778.82,40.1
"2011","Birmingham","E08000025","Urban (total)",1072492,527527,544965,1050813,21679,9427,25718.72,41.7
"2011","Birmingham","E08000025","Urban major conurbation",1072492,527527,544965,1050813,21679,9427,25718.72,41.7
"2011","Birmingham","E08000025","Urban minor conurbation",0,0,0,0,0,0,0.00,
"2011","Birmingham","E08000025","Urban city and town",0,0,0,0,0,0,0.00,
"2011","Birmingham","E08000025","Urban city and town in a sparse setting",0,0,0,0,0,0,0.00,
"2011","Birmingham","E08000025","Rural (total)",553,279,274,553,0,11,1060.10,0.5
"2011","Birmingham","E08000025","Rural town and fringe",0,0,0,0,0,0,0.00,
"2011","Birmingham","E08000025","Rural town and fringe in a sparse setting",0,0,0,0,0,0,0.00,
"2011","Birmingham","E08000025","Rural village",0,0,0,0,0,0,0.00,
"2011","Birmingham","E08000025","Rural village in a sparse setting",0,0,0,0,0,0,0.00,
"2011","Birmingham","E08000025","Rural hamlet and isolated dwellings",553,279,274,553,0,11,1060.10,0.5
"2011","Birmingham","E08000025","Rural hamlet and isolated dwellings in a sparse setting",0,0,0,0,0,0,0.00,
"2011","Coventry","E08000026","Total",316960,157621,159339,307730,9230,3420,9864.42,32.1
"2011","Coventry","E08000026","Urban (total)",316395,157362,159033,307225,9170,3411,8877.72,35.6
"2011","Coventry","E08000026","Urban major conurbation",0,0,0,0,0,0,0.00,
"2011","Coventry","E08000026","Urban minor conurbation",0,0,0,0,0,0,0.00,
"2011","Coventry","E08000026","Urban city and town",316395,157362,159033,307225,9170,3411,8877.72,35.6
"2011","Coventry","E08000026","Urban city and town in a sparse setting",0,0,0,0,0,0,0.00,
"2011","Coventry","E08000026","Rural (total)",565,259,306,505,60,9,986.70,0.6
"2011","Coventry","E08000026","Rural town and fringe",0,0,0,0,0,0,0.00,
"2011","Coventry","E08000026","Rural town and fringe in a sparse setting",0,0,0,0,0,0,0.00,
"2011","Coventry","E08000026","Rural village",0,0,0,0,0,0,0.00,
"2011","Coventry","E08000026","Rural village in a sparse setting",0,0,0,0,0,0,0.00,
"2011","Coventry","E08000026","Rural hamlet and isolated dwellings",565,259,306,505,60,9,986.70,0.6
"2011","Coventry","E08000026","Rural hamlet and isolated dwellings in a sparse setting",0,0,0,0,0,0,0.00,
"2011","Dudley","E08000027","Total",312925,153819,159106,310398,2527,2635,9795.66,31.9
"2011","Dudley","E08000027","Urban (total)",312649,153678,158971,310122,2527,2633,9775.89,32.0
"2011","Dudley","E08000027","Urban major conurbation",312399,153554,158845,309872,2527,2628,9766.50,32.0
"2011","Dudley","E08000027","Urban minor conurbation",0,0,0,0,0,0,0.00,
"2011","Dudley","E08000027","Urban city and town",250,124,126,250,0,5,9.39,26.6
"2011","Dudley","E08000027","Urban city and town in a sparse setting",0,0,0,0,0,0,0.00,
"2011","Dudley","E08000027","Rural (total)",276,141,135,276,0,2,19.77,14.0
"2011","Dudley","E08000027","Rural town and fringe",276,141,135,276,0,2,19.77,14.0
"2011","Dudley","E08000027","Rural town and fringe in a sparse setting",0,0,0,0,0,0,0.00,
"2011","Dudley","E08000027","Rural village",0,0,0,0,0,0,0.00,
"2011","Dudley","E08000027","Rural village in a sparse setting",0,0,0,0,0,0,0.00,
"2011","Dudley","E08000027","Rural hamlet and isolated dwellings",0,0,0,0,0,0,0.00,
"2011","Dudley","E08000027","Rural hamlet and isolated dwellings in a sparse setting",0,0,0,0,0,0,0.00,
"2011","Sandwell","E08000028","Total",308063,151592,156471,305928,2135,1872,8556.73,36.0
"2011","Sandwell","E08000028","Urban (total)",308063,151592,156471,305928,2135,1872,8556.73,36.0
"2011","Sandwell","E08000028","Urban major conurbation",308063,151592,156471,305928,2135,1872,8556.73,36.0
"2011","Sandwell","E08000028","Urban minor conurbation",0,0,0,0,0,0,0.00,
"2011","Sandwell","E08000028","Urban city and town",0,0,0,0,0,0,0.00,
"2011","Sandwell","E08000028","Urban city and town in a sparse setting",0,0,0,0,0,0,0.00,
"2011","Sandwell","E08000028","Rural (total)",0,0,0,0,0,0,0.00,
"2011","Sandwell","E08000028","Rural town and fringe",0,0,0,0,0,0,0.00,
"2011","Sandwell","E08000028","Rural town and fringe in a sparse setting",0,0,0,0,0,0,0.00,
"2011","Sandwell","E08000028","Rural village",0,0,0,0,0,0,0.00,
"2011","Sandwell","E08000028","Rural village in a sparse setting",0,0,0,0,0,0,0.00,
"2011","Sandwell","E08000028","Rural hamlet and isolated dwellings",0,0,0,0,0,0,0.00,
"2011","Sandwell","E08000028","Rural hamlet and isolated dwellings in a sparse setting",0,0,0,0,0,0,0.00,
"2011","Solihull","E08000029","Total",206674,100352,106322,205087,1587,3199,17828.78,11.6
"2011","Solihull","E08000029","Urban (total)",186276,90157,96119,184762,1514,2781,8073.65,23.1
"2011","Solihull","E08000029","Urban major conurbation",182706,88384,94322,181201,1505,2683,6955.21,26.3
"2011","Solihull","E08000029","Urban minor conurbation",0,0,0,0,0,0,0.00,
"2011","Solihull","E08000029","Urban city and town",3570,1773,1797,3561,9,98,1118.44,3.2
"2011","Solihull","E08000029","Urban city and town in a sparse setting",0,0,0,0,0,0,0.00,
"2011","Solihull","E08000029","Rural (total)",20398,10195,10203,20325,73,418,9755.13,2.1
"2011","Solihull","E08000029","Rural town and fringe",14388,7152,7236,14380,8,304,1478.98,9.7
"2011","Solihull","E08000029","Rural town and fringe in a sparse setting",0,0,0,0,0,0,0.00,
"2011","Solihull","E08000029","Rural village",2454,1239,1215,2454,0,57,2094.62,1.2
"2011","Solihull","E08000029","Rural village in a sparse setting",0,0,0,0,0,0,0.00,
"2011","Solihull","E08000029","Rural hamlet and isolated dwellings",3556,1804,1752,3491,65,57,6181.53,0.6
"2011","Solihull","E08000029","Rural hamlet and isolated dwellings in a sparse setting",0,0,0,0,0,0,0.00,
"2011","Walsall","E08000030","Total",269323,132319,137004,267397,1926,2051,10395.49,25.9
"2011","Walsall","E08000030","Urban (total)",266318,130850,135468,264486,1832,2036,9611.68,27.7
"2011","Walsall","E08000030","Urban major conurbation",265682,130548,135134,263850,1832,2022,9521.90,27.9
"2011","Walsall","E08000030","Urban minor conurbation",0,0,0,0,0,0,0.00,
"2011","Walsall","E08000030","Urban city and town",636,302,334,636,0,14,89.78,7.1
"2011","Walsall","E08000030","Urban city and town in a sparse setting",0,0,0,0,0,0,0.00,
"2011","Walsall","E08000030","Rural (total)",3005,1469,1536,2911,94,15,783.81,3.8
"2011","Walsall","E08000030","Rural town and fringe",2169,1048,1121,2134,35,7,40.97,52.9
"2011","Walsall","E08000030","Rural town and fringe in a sparse setting",0,0,0,0,0,0,0.00,
"2011","Walsall","E08000030","Rural village",725,361,364,666,59,7,727.14,1.0
"2011","Walsall","E08000030","Rural village in a sparse setting",0,0,0,0,0,0,0.00,
"2011","Walsall","E08000030","Rural hamlet and isolated dwellings",111,60,51,111,0,1,15.70,7.1
"2011","Walsall","E08000030","Rural hamlet and isolated dwellings in a sparse setting",0,0,0,0,0,0,0.00,
"2011","Wolverhampton","E08000031","Total",249470,123441,126029,245526,3944,2056,6943.95,35.9
"2011","Wolverhampton","E08000031","Urban (total)",249470,123441,126029,245526,3944,2056,6943.95,35.9
"2011","Wolverhampton","E08000031","Urban major conurbation",249470,123441,126029,245526,3944,2056,6943.95,35.9
"2011","Wolverhampton","E08000031","Urban minor conurbation",0,0,0,0,0,0,0.00,
"2011","Wolverhampton","E08000031","Urban city and town",0,0,0,0,0,0,0.00,
"2011","Wolverhampton","E08000031","Urban city and town in a sparse setting",0,0,0,0,0,0,0.00,
"2011","Wolverhampton","E08000031","Rural (total)",0,0,0,0,0,0,0.00,
"2011","Wolverhampton","E08000031","Rural town and fringe",0,0,0,0,0,0,0.00,
"2011","Wolverhampton","E08000031","Rural town and fringe in a sparse setting",0,0,0,0,0,0,0.00,
"2011","Wolverhampton","E08000031","Rural village",0,0,0,0,0,0,0.00,
"2011","Wolverhampton","E08000031","Rural village in a sparse setting",0,0,0,0,0,0,0.00,
"2011","Wolverhampton","E08000031","Rural hamlet and isolated dwellings",0,0,0,0,0,0,0.00,
"2011","Wolverhampton","E08000031","Rural hamlet and isolated dwellings in a sparse setting",0,0,0,0,0,0,0.00,
"2011","Worcestershire","E10000034","Total",566169,278791,287378,556357,9812,7715,174051.71,3.3
"2011","Worcestershire","E10000034","Urban (total)",417021,204606,212415,411119,5902,4915,24136.32,17.3
"2011","Worcestershire","E10000034","Urban major conurbation",18896,9227,9669,18671,225,261,1483.81,12.7
"2011","Worcestershire","E10000034","Urban minor conurbation",0,0,0,0,0,0,0.00,
"2011","Worcestershire","E10000034","Urban city and town",398125,195379,202746,392448,5677,4654,22652.51,17.6
"2011","Worcestershire","E10000034","Urban city and town in a sparse setting",0,0,0,0,0,0,0.00,
"2011","Worcestershire","E10000034","Rural (total)",149148,74185,74963,145238,3910,2800,149915.39,1.0
"2011","Worcestershire","E10000034","Rural town and fringe",50896,25227,25669,49440,1456,741,6923.73,7.4
"2011","Worcestershire","E10000034","Rural town and fringe in a sparse setting",0,0,0,0,0,0,0.00,
"2011","Worcestershire","E10000034","Rural village",55745,27534,28211,54848,897,1039,49602.92,1.1
"2011","Worcestershire","E10000034","Rural village in a sparse setting",0,0,0,0,0,0,0.00,
"2011","Worcestershire","E10000034","Rural hamlet and isolated dwellings",42507,21424,21083,40950,1557,1020,93388.74,0.5
"2011","Worcestershire","E10000034","Rural hamlet and isolated dwellings in a sparse setting",0,0,0,0,0,0,0.00,
"2011","Bedford","E06000055","Total",157479,77312,80167,154536,2943,2392,47641.20,3.3
"2011","Bedford","E06000055","Urban (total)",108375,53323,55052,105861,2514,1422,5743.22,18.9
"2011","Bedford","E06000055","Urban major conurbation",0,0,0,0,0,0,0.00,
"2011","Bedford","E06000055","Urban minor conurbation",0,0,0,0,0,0,0.00,
"2011","Bedford","E06000055","Urban city and town",108375,53323,55052,105861,2514,1422,5743.22,18.9
"2011","Bedford","E06000055","Urban city and town in a sparse setting",0,0,0,0,0,0,0.00,
"2011","Bedford","E06000055","Rural (total)",49104,23989,25115,48675,429,970,41897.98,1.2
"2011","Bedford","E06000055","Rural town and fringe",24877,12029,12848,24652,225,387,3253.57,7.6
"2011","Bedford","E06000055","Rural town and fringe in a sparse setting",0,0,0,0,0,0,0.00,
"2011","Bedford","E06000055","Rural village",16638,8179,8459,16493,145,378,20364.48,0.8
"2011","Bedford","E06000055","Rural village in a sparse setting",0,0,0,0,0,0,0.00,
"2011","Bedford","E06000055","Rural hamlet and isolated dwellings",7589,3781,3808,7530,59,205,18279.93,0.4
"2011","Bedford","E06000055","Rural hamlet and isolated dwellings in a sparse setting",0,0,0,0,0,0,0.00,
"2011","Central Bedfordshire","E06000056","Total",254381,126044,128337,252120,2261,3629,71566.45,3.6
"2011","Central Bedfordshire","E06000056","Urban (total)",154109,76058,78051,153185,924,2009,11529.50,13.4
"2011","Central Bedfordshire","E06000056","Urban major conurbation",0,0,0,0,0,0,0.00,
"2011","Central Bedfordshire","E06000056","Urban minor conurbation",0,0,0,0,0,0,0.00,
"2011","Central Bedfordshire","E06000056","Urban city and town",154109,76058,78051,153185,924,2009,11529.50,13.4
"2011","Central Bedfordshire","E06000056","Urban city and town in a sparse setting",0,0,0,0,0,0,0.00,
"2011","Central Bedfordshire","E06000056","Rural (total)",100272,49986,50286,98935,1337,1620,60036.95,1.7
"2011","Central Bedfordshire","E06000056","Rural town and fringe",64306,31877,32429,63946,360,949,12246.59,5.3
"2011","Central Bedfordshire","E06000056","Rural town and fringe in a sparse setting",0,0,0,0,0,0,0.00,
"2011","Central Bedfordshire","E06000056","Rural village",27485,13877,13608,26630,855,475,25964.55,1.1
"2011","Central Bedfordshire","E06000056","Rural village in a sparse setting",0,0,0,0,0,0,0.00,
"2011","Central Bedfordshire","E06000056","Rural hamlet and isolated dwellings",8481,4232,4249,8359,122,196,21825.81,0.4
"2011","Central Bedfordshire","E06000056","Rural hamlet and isolated dwellings in a sparse setting",0,0,0,0,0,0,0.00,
"2011","Luton","E06000032","Total",203201,101954,101247,201549,1652,2232,4335.33,46.9
"2011","Luton","E06000032","Urban (total)",203201,101954,101247,201549,1652,2232,4335.33,46.9
"2011","Luton","E06000032","Urban major conurbation",0,0,0,0,0,0,0.00,
"2011","Luton","E06000032","Urban minor conurbation",0,0,0,0,0,0,0.00,
"2011","Luton","E06000032","Urban city and town",203201,101954,101247,201549,1652,2232,4335.33,46.9
"2011","Luton","E06000032","Urban city and town in a sparse setting",0,0,0,0,0,0,0.00,
"2011","Luton","E06000032","Rural (total)",0,0,0,0,0,0,0.00,
"2011","Luton","E06000032","Rural town and fringe",0,0,0,0,0,0,0.00,
"2011","Luton","E06000032","Rural town and fringe in a sparse setting",0,0,0,0,0,0,0.00,
"2011","Luton","E06000032","Rural village",0,0,0,0,0,0,0.00,
"2011","Luton","E06000032","Rural village in a sparse setting",0,0,0,0,0,0,0.00,
"2011","Luton","E06000032","Rural hamlet and isolated dwellings",0,0,0,0,0,0,0.00,
"2011","Luton","E06000032","Rural hamlet and isolated dwellings in a sparse setting",0,0,0,0,0,0,0.00,
"2011","Peterborough","E06000031","Total",183631,90859,92772,181827,1804,2040,34337.82,5.3
"2011","Peterborough","E06000031","Urban (total)",161879,80003,81876,160598,1281,1679,8357.97,19.4
"2011","Peterborough","E06000031","Urban major conurbation",0,0,0,0,0,0,0.00,
"2011","Peterborough","E06000031","Urban minor conurbation",0,0,0,0,0,0,0.00,
"2011","Peterborough","E06000031","Urban city and town",161879,80003,81876,160598,1281,1679,8357.97,19.4
"2011","Peterborough","E06000031","Urban city and town in a sparse setting",0,0,0,0,0,0,0.00,
"2011","Peterborough","E06000031","Rural (total)",21752,10856,10896,21229,523,361,25979.85,0.8
"2011","Peterborough","E06000031","Rural town and fringe",13618,6792,6826,13112,506,168,4718.78,2.9
"2011","Peterborough","E06000031","Rural town and fringe in a sparse setting",0,0,0,0,0,0,0.00,
"2011","Peterborough","E06000031","Rural village",6505,3196,3309,6490,15,159,7214.93,0.9
"2011","Peterborough","E06000031","Rural village in a sparse setting",0,0,0,0,0,0,0.00,
"2011","Peterborough","E06000031","Rural hamlet and isolated dwellings",1629,868,761,1627,2,34,14046.14,0.1
"2011","Peterborough","E06000031","Rural hamlet and isolated dwellings in a sparse setting",0,0,0,0,0,0,0.00,
"2011","Southend-on-Sea","E06000033","Total",173658,85037,88621,171489,2169,1852,4175.60,41.6
"2011","Southend-on-Sea","E06000033","Urban (total)",173658,85037,88621,171489,2169,1852,4175.60,41.6
"2011","Southend-on-Sea","E06000033","Urban major conurbation",0,0,0,0,0,0,0.00,
"2011","Southend-on-Sea","E06000033","Urban minor conurbation",0,0,0,0,0,0,0.00,
"2011","Southend-on-Sea","E06000033","Urban city and town",173658,85037,88621,171489,2169,1852,4175.60,41.6
"2011","Southend-on-Sea","E06000033","Urban city and town in a sparse setting",0,0,0,0,0,0,0.00,
"2011","Southend-on-Sea","E06000033","Rural (total)",0,0,0,0,0,0,0.00,
"2011","Southend-on-Sea","E06000033","Rural town and fringe",0,0,0,0,0,0,0.00,
"2011","Southend-on-Sea","E06000033","Rural town and fringe in a sparse setting",0,0,0,0,0,0,0.00,
"2011","Southend-on-Sea","E06000033","Rural village",0,0,0,0,0,0,0.00,
"2011","Southend-on-Sea","E06000033","Rural village in a sparse setting",0,0,0,0,0,0,0.00,
"2011","Southend-on-Sea","E06000033","Rural hamlet and isolated dwellings",0,0,0,0,0,0,0.00,
"2011","Southend-on-Sea","E06000033","Rural hamlet and isolated dwellings in a sparse setting",0,0,0,0,0,0,0.00,
"2011","Thurrock","E06000034","Total",157705,77823,79882,157072,633,1302,16337.60,9.7
"2011","Thurrock","E06000034","Urban (total)",137940,68077,69863,137345,595,1105,9053.70,15.2
"2011","Thurrock","E06000034","Urban major conurbation",105380,52252,53128,104914,466,820,4739.85,22.2
"2011","Thurrock","E06000034","Urban minor conurbation",0,0,0,0,0,0,0.00,
"2011","Thurrock","E06000034","Urban city and town",32560,15825,16735,32431,129,285,4313.85,7.5
"2011","Thurrock","E06000034","Urban city and town in a sparse setting",0,0,0,0,0,0,0.00,
"2011","Thurrock","E06000034","Rural (total)",19765,9746,10019,19727,38,197,7283.90,2.7
"2011","Thurrock","E06000034","Rural town and fringe",16463,8112,8351,16450,13,146,2162.81,7.6
"2011","Thurrock","E06000034","Rural town and fringe in a sparse setting",0,0,0,0,0,0,0.00,
"2011","Thurrock","E06000034","Rural village",2727,1346,1381,2702,25,42,2045.72,1.3
"2011","Thurrock","E06000034","Rural village in a sparse setting",0,0,0,0,0,0,0.00,
"2011","Thurrock","E06000034","Rural hamlet and isolated dwellings",575,288,287,575,0,9,3075.37,0.2
"2011","Thurrock","E06000034","Rural hamlet and isolated dwellings in a sparse setting",0,0,0,0,0,0,0.00,
"2011","Cambridgeshire","E10000003","Total",621210,309560,311650,598066,23144,9352,304624.19,2.0
"2011","Cambridgeshire","E10000003","Urban (total)",328577,163625,164952,309573,19004,4371,30398.65,10.8
"2011","Cambridgeshire","E10000003","Urban major conurbation",0,0,0,0,0,0,0.00,
"2011","Cambridgeshire","E10000003","Urban minor conurbation",0,0,0,0,0,0,0.00,
"2011","Cambridgeshire","E10000003","Urban city and town",328577,163625,164952,309573,19004,4371,30398.65,10.8
"2011","Cambridgeshire","E10000003","Urban city and town in a sparse setting",0,0,0,0,0,0,0.00,
"2011","Cambridgeshire","E10000003","Rural (total)",292633,145935,146698,288493,4140,4981,274225.54,1.1
"2011","Cambridgeshire","E10000003","Rural town and fringe",177303,87446,89857,175859,1444,2679,42195.25,4.2
"2011","Cambridgeshire","E10000003","Rural town and fringe in a sparse setting",0,0,0,0,0,0,0.00,
"2011","Cambridgeshire","E10000003","Rural village",88356,44814,43542,85966,2390,1811,111570.49,0.8
"2011","Cambridgeshire","E10000003","Rural village in a sparse setting",0,0,0,0,0,0,0.00,
"2011","Cambridgeshire","E10000003","Rural hamlet and isolated dwellings",26974,13675,13299,26668,306,491,120459.80,0.2
"2011","Cambridgeshire","E10000003","Rural hamlet and isolated dwellings in a sparse setting",0,0,0,0,0,0,0.00,
"2011","Essex","E10000012","Total",1393587,680161,713426,1375440,18147,17298,346438.95,4.0
"2011","Essex","E10000012","Urban (total)",1032982,502495,530487,1021293,11689,11328,61200.78,16.9
"2011","Essex","E10000012","Urban major conurbation",73097,35226,37871,72443,654,956,3705.81,19.7
"2011","Essex","E10000012","Urban minor conurbation",0,0,0,0,0,0,0.00,
"2011","Essex","E10000012","Urban city and town",959885,467269,492616,948850,11035,10372,57494.97,16.7
"2011","Essex","E10000012","Urban city and town in a sparse setting",0,0,0,0,0,0,0.00,
"2011","Essex","E10000012","Rural (total)",360605,177666,182939,354147,6458,5970,285238.17,1.3
"2011","Essex","E10000012","Rural town and fringe",193057,94255,98802,191494,1563,2579,24796.81,7.8
"2011","Essex","E10000012","Rural town and fringe in a sparse setting",0,0,0,0,0,0,0.00,
"2011","Essex","E10000012","Rural village",100321,49908,50413,98900,1421,1838,89417.73,1.1
"2011","Essex","E10000012","Rural village in a sparse setting",0,0,0,0,0,0,0.00,
"2011","Essex","E10000012","Rural hamlet and isolated dwellings",67227,33503,33724,63753,3474,1553,171023.63,0.4
"2011","Essex","E10000012","Rural hamlet and isolated dwellings in a sparse setting",0,0,0,0,0,0,0.00,
"2011","Hertfordshire","E10000015","Total",1116062,547110,568952,1101351,14711,18561,164306.58,6.8
"2011","Hertfordshire","E10000015","Urban (total)",987478,483767,503711,975648,11830,15475,53147.52,18.6
"2011","Hertfordshire","E10000015","Urban major conurbation",409182,199968,209214,405740,3442,5772,16803.57,24.4
"2011","Hertfordshire","E10000015","Urban minor conurbation",0,0,0,0,0,0,0.00,
"2011","Hertfordshire","E10000015","Urban city and town",578296,283799,294497,569908,8388,9703,36343.95,15.9
"2011","Hertfordshire","E10000015","Urban city and town in a sparse setting",0,0,0,0,0,0,0.00,
"2011","Hertfordshire","E10000015","Rural (total)",128584,63343,65241,125703,2881,3086,111159.06,1.2
"2011","Hertfordshire","E10000015","Rural town and fringe",59900,29561,30339,58873,1027,1185,7952.54,7.5
"2011","Hertfordshire","E10000015","Rural town and fringe in a sparse setting",0,0,0,0,0,0,0.00,
"2011","Hertfordshire","E10000015","Rural village",47209,23189,24020,46528,681,1141,49657.28,1.0
"2011","Hertfordshire","E10000015","Rural village in a sparse setting",0,0,0,0,0,0,0.00,
"2011","Hertfordshire","E10000015","Rural hamlet and isolated dwellings",21475,10593,10882,20302,1173,760,53549.24,0.4
"2011","Hertfordshire","E10000015","Rural hamlet and isolated dwellings in a sparse setting",0,0,0,0,0,0,0.00,
"2011","Norfolk","E10000020","Total",857888,420160,437728,841042,16846,9721,537056.10,1.6
"2011","Norfolk","E10000020","Urban (total)",429175,210092,219083,421095,8080,4002,33561.16,12.8
"2011","Norfolk","E10000020","Urban major conurbation",0,0,0,0,0,0,0.00,
"2011","Norfolk","E10000020","Urban minor conurbation",0,0,0,0,0,0,0.00,
"2011","Norfolk","E10000020","Urban city and town",429175,210092,219083,421095,8080,4002,33561.16,12.8
"2011","Norfolk","E10000020","Urban city and town in a sparse setting",0,0,0,0,0,0,0.00,
"2011","Norfolk","E10000020","Rural (total)",428713,210068,218645,419947,8766,5719,503494.94,0.9
"2011","Norfolk","E10000020","Rural town and fringe",158559,76406,82153,155057,3502,1685,28315.59,5.6
"2011","Norfolk","E10000020","Rural town and fringe in a sparse setting",22696,10692,12004,22215,481,236,5282.00,4.3
"2011","Norfolk","E10000020","Rural village",154966,77127,77839,151888,3078,2152,181672.03,0.9
"2011","Norfolk","E10000020","Rural village in a sparse setting",14033,6899,7134,13977,56,250,40240.33,0.3
"2011","Norfolk","E10000020","Rural hamlet and isolated dwellings",74707,37147,37560,73061,1646,1305,229706.88,0.3
"2011","Norfolk","E10000020","Rural hamlet and isolated dwellings in a sparse setting",3752,1797,1955,3749,3,91,18278.11,0.2
"2011","Suffolk","E10000029","Total",728163,359787,368376,714113,14050,9780,380018.39,1.9
"2011","Suffolk","E10000029","Urban (total)",439442,215868,223574,433954,5488,4730,26803.04,16.4
"2011","Suffolk","E10000029","Urban major conurbation",0,0,0,0,0,0,0.00,
"2011","Suffolk","E10000029","Urban minor conurbation",0,0,0,0,0,0,0.00,
"2011","Suffolk","E10000029","Urban city and town",439442,215868,223574,433954,5488,4730,26803.04,16.4
"2011","Suffolk","E10000029","Urban city and town in a sparse setting",0,0,0,0,0,0,0.00,
"2011","Suffolk","E10000029","Rural (total)",288721,143919,144802,280159,8562,5050,353215.35,0.8
"2011","Suffolk","E10000029","Rural town and fringe",108310,52894,55416,106090,2220,1295,23134.59,4.7
"2011","Suffolk","E10000029","Rural town and fringe in a sparse setting",7421,3531,3890,7297,124,79,838.79,8.8
"2011","Suffolk","E10000029","Rural village",110597,55704,54893,106528,4069,2145,134762.73,0.8
"2011","Suffolk","E10000029","Rural village in a sparse setting",231,109,122,231,0,5,143.81,1.6
"2011","Suffolk","E10000029","Rural hamlet and isolated dwellings",61081,31180,29901,58979,2102,1510,191750.85,0.3
"2011","Suffolk","E10000029","Rural hamlet and isolated dwellings in a sparse setting",1081,501,580,1034,47,16,2584.58,0.4
"2011","Camden","E09000007","Total",220338,107885,112453,212443,7895,2530,2179.60,101.1
"2011","Camden","E09000007","Urban (total)",220338,107885,112453,212443,7895,2530,2179.60,101.1
"2011","Camden","E09000007","Urban major conurbation",220338,107885,112453,212443,7895,2530,2179.60,101.1
"2011","Camden","E09000007","Urban minor conurbation",0,0,0,0,0,0,0.00,
"2011","Camden","E09000007","Urban city and town",0,0,0,0,0,0,0.00,
"2011","Camden","E09000007","Urban city and town in a sparse setting",0,0,0,0,0,0,0.00,
"2011","Camden","E09000007","Rural (total)",0,0,0,0,0,0,0.00,
"2011","Camden","E09000007","Rural town and fringe",0,0,0,0,0,0,0.00,
"2011","Camden","E09000007","Rural town and fringe in a sparse setting",0,0,0,0,0,0,0.00,
"2011","Camden","E09000007","Rural village",0,0,0,0,0,0,0.00,
"2011","Camden","E09000007","Rural village in a sparse setting",0,0,0,0,0,0,0.00,
"2011","Camden","E09000007","Rural hamlet and isolated dwellings",0,0,0,0,0,0,0.00,
"2011","Camden","E09000007","Rural hamlet and isolated dwellings in a sparse setting",0,0,0,0,0,0,0.00,
"2011","City of London","E09000001","Total",7375,4091,3284,7187,188,78,289.78,25.5
"2011","City of London","E09000001","Urban (total)",7375,4091,3284,7187,188,78,289.78,25.5
"2011","City of London","E09000001","Urban major conurbation",7375,4091,3284,7187,188,78,289.78,25.5
"2011","City of London","E09000001","Urban minor conurbation",0,0,0,0,0,0,0.00,
"2011","City of London","E09000001","Urban city and town",0,0,0,0,0,0,0.00,
"2011","City of London","E09000001","Urban city and town in a sparse setting",0,0,0,0,0,0,0.00,
"2011","City of London","E09000001","Rural (total)",0,0,0,0,0,0,0.00,
"2011","City of London","E09000001","Rural town and fringe",0,0,0,0,0,0,0.00,
"2011","City of London","E09000001","Rural town and fringe in a sparse setting",0,0,0,0,0,0,0.00,
"2011","City of London","E09000001","Rural village",0,0,0,0,0,0,0.00,
"2011","City of London","E09000001","Rural village in a sparse setting",0,0,0,0,0,0,0.00,
"2011","City of London","E09000001","Rural hamlet and isolated dwellings",0,0,0,0,0,0,0.00,
"2011","City of London","E09000001","Rural hamlet and isolated dwellings in a sparse setting",0,0,0,0,0,0,0.00,
"2011","Hackney","E09000012","Total",246270,122029,124241,244433,1837,2221,1906.35,129.2
"2011","Hackney","E09000012","Urban (total)",245645,121741,123904,243808,1837,2211,1895.31,129.6
"2011","Hackney","E09000012","Urban major conurbation",245645,121741,123904,243808,1837,2211,1895.31,129.6
"2011","Hackney","E09000012","Urban minor conurbation",0,0,0,0,0,0,0.00,
"2011","Hackney","E09000012","Urban city and town",0,0,0,0,0,0,0.00,
"2011","Hackney","E09000012","Urban city and town in a sparse setting",0,0,0,0,0,0,0.00,
"2011","Hackney","E09000012","Rural (total)",625,288,337,625,0,10,11.04,56.6
"2011","Hackney","E09000012","Rural town and fringe",625,288,337,625,0,10,11.04,56.6
"2011","Hackney","E09000012","Rural town and fringe in a sparse setting",0,0,0,0,0,0,0.00,
"2011","Hackney","E09000012","Rural village",0,0,0,0,0,0,0.00,
"2011","Hackney","E09000012","Rural village in a sparse setting",0,0,0,0,0,0,0.00,
"2011","Hackney","E09000012","Rural hamlet and isolated dwellings",0,0,0,0,0,0,0.00,
"2011","Hackney","E09000012","Rural hamlet and isolated dwellings in a sparse setting",0,0,0,0,0,0,0.00,
"2011","Hammersmith and Fulham","E09000013","Total",182493,88914,93579,180652,1841,2327,1640.40,111.2
"2011","Hammersmith and Fulham","E09000013","Urban (total)",182493,88914,93579,180652,1841,2327,1640.40,111.2
"2011","Hammersmith and Fulham","E09000013","Urban major conurbation",182493,88914,93579,180652,1841,2327,1640.40,111.2
"2011","Hammersmith and Fulham","E09000013","Urban minor conurbation",0,0,0,0,0,0,0.00,
"2011","Hammersmith and Fulham","E09000013","Urban city and town",0,0,0,0,0,0,0.00,
"2011","Hammersmith and Fulham","E09000013","Urban city and town in a sparse setting",0,0,0,0,0,0,0.00,
"2011","Hammersmith and Fulham","E09000013","Rural (total)",0,0,0,0,0,0,0.00,
"2011","Hammersmith and Fulham","E09000013","Rural town and fringe",0,0,0,0,0,0,0.00,
"2011","Hammersmith and Fulham","E09000013","Rural town and fringe in a sparse setting",0,0,0,0,0,0,0.00,
"2011","Hammersmith and Fulham","E09000013","Rural village",0,0,0,0,0,0,0.00,
"2011","Hammersmith and Fulham","E09000013","Rural village in a sparse setting",0,0,0,0,0,0,0.00,
"2011","Hammersmith and Fulham","E09000013","Rural hamlet and isolated dwellings",0,0,0,0,0,0,0.00,
"2011","Hammersmith and Fulham","E09000013","Rural hamlet and isolated dwellings in a sparse setting",0,0,0,0,0,0,0.00,
"2011","Haringey","E09000014","Total",254926,126224,128702,253236,1690,2774,2958.85,86.2
"2011","Haringey","E09000014","Urban (total)",254926,126224,128702,253236,1690,2774,2958.85,86.2
"2011","Haringey","E09000014","Urban major conurbation",254926,126224,128702,253236,1690,2774,2958.85,86.2
"2011","Haringey","E09000014","Urban minor conurbation",0,0,0,0,0,0,0.00,
"2011","Haringey","E09000014","Urban city and town",0,0,0,0,0,0,0.00,
"2011","Haringey","E09000014","Urban city and town in a sparse setting",0,0,0,0,0,0,0.00,
"2011","Haringey","E09000014","Rural (total)",0,0,0,0,0,0,0.00,
"2011","Haringey","E09000014","Rural town and fringe",0,0,0,0,0,0,0.00,
"2011","Haringey","E09000014","Rural town and fringe in a sparse setting",0,0,0,0,0,0,0.00,
"2011","Haringey","E09000014","Rural village",0,0,0,0,0,0,0.00,
"2011","Haringey","E09000014","Rural village in a sparse setting",0,0,0,0,0,0,0.00,
"2011","Haringey","E09000014","Rural hamlet and isolated dwellings",0,0,0,0,0,0,0.00,
"2011","Haringey","E09000014","Rural hamlet and isolated dwellings in a sparse setting",0,0,0,0,0,0,0.00,
"2011","Islington","E09000019","Total",206125,101405,104720,200134,5991,1931,1485.95,138.7
"2011","Islington","E09000019","Urban (total)",206125,101405,104720,200134,5991,1931,1485.95,138.7
"2011","Islington","E09000019","Urban major conurbation",206125,101405,104720,200134,5991,1931,1485.95,138.7
"2011","Islington","E09000019","Urban minor conurbation",0,0,0,0,0,0,0.00,
"2011","Islington","E09000019","Urban city and town",0,0,0,0,0,0,0.00,
"2011","Islington","E09000019","Urban city and town in a sparse setting",0,0,0,0,0,0,0.00,
"2011","Islington","E09000019","Rural (total)",0,0,0,0,0,0,0.00,
"2011","Islington","E09000019","Rural town and fringe",0,0,0,0,0,0,0.00,
"2011","Islington","E09000019","Rural town and fringe in a sparse setting",0,0,0,0,0,0,0.00,
"2011","Islington","E09000019","Rural village",0,0,0,0,0,0,0.00,
"2011","Islington","E09000019","Rural village in a sparse setting",0,0,0,0,0,0,0.00,
"2011","Islington","E09000019","Rural hamlet and isolated dwellings",0,0,0,0,0,0,0.00,
"2011","Islington","E09000019","Rural hamlet and isolated dwellings in a sparse setting",0,0,0,0,0,0,0.00,
"2011","Kensington and Chelsea","E09000020","Total",158649,78194,80455,155939,2710,3093,1212.95,130.8
"2011","Kensington and Chelsea","E09000020","Urban (total)",158649,78194,80455,155939,2710,3093,1212.95,130.8
"2011","Kensington and Chelsea","E09000020","Urban major conurbation",158649,78194,80455,155939,2710,3093,1212.95,130.8
"2011","Kensington and Chelsea","E09000020","Urban minor conurbation",0,0,0,0,0,0,0.00,
"2011","Kensington and Chelsea","E09000020","Urban city and town",0,0,0,0,0,0,0.00,
"2011","Kensington and Chelsea","E09000020","Urban city and town in a sparse setting",0,0,0,0,0,0,0.00,
"2011","Kensington and Chelsea","E09000020","Rural (total)",0,0,0,0,0,0,0.00,
"2011","Kensington and Chelsea","E09000020","Rural town and fringe",0,0,0,0,0,0,0.00,
"2011","Kensington and Chelsea","E09000020","Rural town and fringe in a sparse setting",0,0,0,0,0,0,0.00,
"2011","Kensington and Chelsea","E09000020","Rural village",0,0,0,0,0,0,0.00,
"2011","Kensington and Chelsea","E09000020","Rural village in a sparse setting",0,0,0,0,0,0,0.00,
"2011","Kensington and Chelsea","E09000020","Rural hamlet and isolated dwellings",0,0,0,0,0,0,0.00,
"2011","Kensington and Chelsea","E09000020","Rural hamlet and isolated dwellings in a sparse setting",0,0,0,0,0,0,0.00,
"2011","Lambeth","E09000022","Total",303086,150921,152165,300101,2985,3186,2682.14,113.0
"2011","Lambeth","E09000022","Urban (total)",303086,150921,152165,300101,2985,3186,2682.14,113.0
"2011","Lambeth","E09000022","Urban major conurbation",303086,150921,152165,300101,2985,3186,2682.14,113.0
"2011","Lambeth","E09000022","Urban minor conurbation",0,0,0,0,0,0,0.00,
"2011","Lambeth","E09000022","Urban city and town",0,0,0,0,0,0,0.00,
"2011","Lambeth","E09000022","Urban city and town in a sparse setting",0,0,0,0,0,0,0.00,
"2011","Lambeth","E09000022","Rural (total)",0,0,0,0,0,0,0.00,
"2011","Lambeth","E09000022","Rural town and fringe",0,0,0,0,0,0,0.00,
"2011","Lambeth","E09000022","Rural town and fringe in a sparse setting",0,0,0,0,0,0,0.00,
"2011","Lambeth","E09000022","Rural village",0,0,0,0,0,0,0.00,
"2011","Lambeth","E09000022","Rural village in a sparse setting",0,0,0,0,0,0,0.00,
"2011","Lambeth","E09000022","Rural hamlet and isolated dwellings",0,0,0,0,0,0,0.00,
"2011","Lambeth","E09000022","Rural hamlet and isolated dwellings in a sparse setting",0,0,0,0,0,0,0.00,
"2011","Lewisham","E09000023","Total",275885,134957,140928,273342,2543,2897,3514.54,78.5
"2011","Lewisham","E09000023","Urban (total)",275885,134957,140928,273342,2543,2897,3514.54,78.5
"2011","Lewisham","E09000023","Urban major conurbation",275885,134957,140928,273342,2543,2897,3514.54,78.5
"2011","Lewisham","E09000023","Urban minor conurbation",0,0,0,0,0,0,0.00,
"2011","Lewisham","E09000023","Urban city and town",0,0,0,0,0,0,0.00,
"2011","Lewisham","E09000023","Urban city and town in a sparse setting",0,0,0,0,0,0,0.00,
"2011","Lewisham","E09000023","Rural (total)",0,0,0,0,0,0,0.00,
"2011","Lewisham","E09000023","Rural town and fringe",0,0,0,0,0,0,0.00,
"2011","Lewisham","E09000023","Rural town and fringe in a sparse setting",0,0,0,0,0,0,0.00,
"2011","Lewisham","E09000023","Rural village",0,0,0,0,0,0,0.00,
"2011","Lewisham","E09000023","Rural village in a sparse setting",0,0,0,0,0,0,0.00,
"2011","Lewisham","E09000023","Rural hamlet and isolated dwellings",0,0,0,0,0,0,0.00,
"2011","Lewisham","E09000023","Rural hamlet and isolated dwellings in a sparse setting",0,0,0,0,0,0,0.00,
"2011","Newham","E09000025","Total",307984,160336,147648,306009,1975,2461,3622.36,85.0
"2011","Newham","E09000025","Urban (total)",307984,160336,147648,306009,1975,2461,3622.36,85.0
"2011","Newham","E09000025","Urban major conurbation",307984,160336,147648,306009,1975,2461,3622.36,85.0
"2011","Newham","E09000025","Urban minor conurbation",0,0,0,0,0,0,0.00,
"2011","Newham","E09000025","Urban city and town",0,0,0,0,0,0,0.00,
"2011","Newham","E09000025","Urban city and town in a sparse setting",0,0,0,0,0,0,0.00,
"2011","Newham","E09000025","Rural (total)",0,0,0,0,0,0,0.00,
"2011","Newham","E09000025","Rural town and fringe",0,0,0,0,0,0,0.00,
"2011","Newham","E09000025","Rural town and fringe in a sparse setting",0,0,0,0,0,0,0.00,
"2011","Newham","E09000025","Rural village",0,0,0,0,0,0,0.00,
"2011","Newham","E09000025","Rural village in a sparse setting",0,0,0,0,0,0,0.00,
"2011","Newham","E09000025","Rural hamlet and isolated dwellings",0,0,0,0,0,0,0.00,
"2011","Newham","E09000025","Rural hamlet and isolated dwellings in a sparse setting",0,0,0,0,0,0,0.00,
"2011","Southwark","E09000028","Total",288283,142618,145665,282560,5723,3087,2885.41,99.9
"2011","Southwark","E09000028","Urban (total)",288283,142618,145665,282560,5723,3087,2885.41,99.9
"2011","Southwark","E09000028","Urban major conurbation",288283,142618,145665,282560,5723,3087,2885.41,99.9
"2011","Southwark","E09000028","Urban minor conurbation",0,0,0,0,0,0,0.00,
"2011","Southwark","E09000028","Urban city and town",0,0,0,0,0,0,0.00,
"2011","Southwark","E09000028","Urban city and town in a sparse setting",0,0,0,0,0,0,0.00,
"2011","Southwark","E09000028","Rural (total)",0,0,0,0,0,0,0.00,
"2011","Southwark","E09000028","Rural town and fringe",0,0,0,0,0,0,0.00,
"2011","Southwark","E09000028","Rural town and fringe in a sparse setting",0,0,0,0,0,0,0.00,
"2011","Southwark","E09000028","Rural village",0,0,0,0,0,0,0.00,
"2011","Southwark","E09000028","Rural village in a sparse setting",0,0,0,0,0,0,0.00,
"2011","Southwark","E09000028","Rural hamlet and isolated dwellings",0,0,0,0,0,0,0.00,
"2011","Southwark","E09000028","Rural hamlet and isolated dwellings in a sparse setting",0,0,0,0,0,0,0.00,
"2011","Tower Hamlets","E09000030","Total",254096,130906,123190,250343,3753,1497,1976.90,128.5
"2011","Tower Hamlets","E09000030","Urban (total)",254096,130906,123190,250343,3753,1497,1976.90,128.5
"2011","Tower Hamlets","E09000030","Urban major conurbation",254096,130906,123190,250343,3753,1497,1976.90,128.5
"2011","Tower Hamlets","E09000030","Urban minor conurbation",0,0,0,0,0,0,0.00,
"2011","Tower Hamlets","E09000030","Urban city and town",0,0,0,0,0,0,0.00,
"2011","Tower Hamlets","E09000030","Urban city and town in a sparse setting",0,0,0,0,0,0,0.00,
"2011","Tower Hamlets","E09000030","Rural (total)",0,0,0,0,0,0,0.00,
"2011","Tower Hamlets","E09000030","Rural town and fringe",0,0,0,0,0,0,0.00,
"2011","Tower Hamlets","E09000030","Rural town and fringe in a sparse setting",0,0,0,0,0,0,0.00,
"2011","Tower Hamlets","E09000030","Rural village",0,0,0,0,0,0,0.00,
"2011","Tower Hamlets","E09000030","Rural village in a sparse setting",0,0,0,0,0,0,0.00,
"2011","Tower Hamlets","E09000030","Rural hamlet and isolated dwellings",0,0,0,0,0,0,0.00,
"2011","Tower Hamlets","E09000030","Rural hamlet and isolated dwellings in a sparse setting",0,0,0,0,0,0,0.00,
"2011","Wandsworth","E09000032","Total",306995,148646,158349,301648,5347,4236,3426.29,89.6
"2011","Wandsworth","E09000032","Urban (total)",306995,148646,158349,301648,5347,4236,3426.29,89.6
"2011","Wandsworth","E09000032","Urban major conurbation",306995,148646,158349,301648,5347,4236,3426.29,89.6
"2011","Wandsworth","E09000032","Urban minor conurbation",0,0,0,0,0,0,0.00,
"2011","Wandsworth","E09000032","Urban city and town",0,0,0,0,0,0,0.00,
"2011","Wandsworth","E09000032","Urban city and town in a sparse setting",0,0,0,0,0,0,0.00,
"2011","Wandsworth","E09000032","Rural (total)",0,0,0,0,0,0,0.00,
"2011","Wandsworth","E09000032","Rural town and fringe",0,0,0,0,0,0,0.00,
"2011","Wandsworth","E09000032","Rural town and fringe in a sparse setting",0,0,0,0,0,0,0.00,
"2011","Wandsworth","E09000032","Rural village",0,0,0,0,0,0,0.00,
"2011","Wandsworth","E09000032","Rural village in a sparse setting",0,0,0,0,0,0,0.00,
"2011","Wandsworth","E09000032","Rural hamlet and isolated dwellings",0,0,0,0,0,0,0.00,
"2011","Wandsworth","E09000032","Rural hamlet and isolated dwellings in a sparse setting",0,0,0,0,0,0,0.00,
"2011","Westminster","E09000033","Total",219396,111548,107848,213208,6188,3171,2147.78,102.2
"2011","Westminster","E09000033","Urban (total)",219396,111548,107848,213208,6188,3171,2147.78,102.2
"2011","Westminster","E09000033","Urban major conurbation",219396,111548,107848,213208,6188,3171,2147.78,102.2
"2011","Westminster","E09000033","Urban minor conurbation",0,0,0,0,0,0,0.00,
"2011","Westminster","E09000033","Urban city and town",0,0,0,0,0,0,0.00,
"2011","Westminster","E09000033","Urban city and town in a sparse setting",0,0,0,0,0,0,0.00,
"2011","Westminster","E09000033","Rural (total)",0,0,0,0,0,0,0.00,
"2011","Westminster","E09000033","Rural town and fringe",0,0,0,0,0,0,0.00,
"2011","Westminster","E09000033","Rural town and fringe in a sparse setting",0,0,0,0,0,0,0.00,
"2011","Westminster","E09000033","Rural village",0,0,0,0,0,0,0.00,
"2011","Westminster","E09000033","Rural village in a sparse setting",0,0,0,0,0,0,0.00,
"2011","Westminster","E09000033","Rural hamlet and isolated dwellings",0,0,0,0,0,0,0.00,
"2011","Westminster","E09000033","Rural hamlet and isolated dwellings in a sparse setting",0,0,0,0,0,0,0.00,
"2011","Barking and Dagenham","E09000002","Total",185911,90237,95674,184901,1010,1654,3609.04,51.5
"2011","Barking and Dagenham","E09000002","Urban (total)",185911,90237,95674,184901,1010,1654,3609.04,51.5
"2011","Barking and Dagenham","E09000002","Urban major conurbation",185911,90237,95674,184901,1010,1654,3609.04,51.5
"2011","Barking and Dagenham","E09000002","Urban minor conurbation",0,0,0,0,0,0,0.00,
"2011","Barking and Dagenham","E09000002","Urban city and town",0,0,0,0,0,0,0.00,
"2011","Barking and Dagenham","E09000002","Urban city and town in a sparse setting",0,0,0,0,0,0,0.00,
"2011","Barking and Dagenham","E09000002","Rural (total)",0,0,0,0,0,0,0.00,
"2011","Barking and Dagenham","E09000002","Rural town and fringe",0,0,0,0,0,0,0.00,
"2011","Barking and Dagenham","E09000002","Rural town and fringe in a sparse setting",0,0,0,0,0,0,0.00,
"2011","Barking and Dagenham","E09000002","Rural village",0,0,0,0,0,0,0.00,
"2011","Barking and Dagenham","E09000002","Rural village in a sparse setting",0,0,0,0,0,0,0.00,
"2011","Barking and Dagenham","E09000002","Rural hamlet and isolated dwellings",0,0,0,0,0,0,0.00,
"2011","Barking and Dagenham","E09000002","Rural hamlet and isolated dwellings in a sparse setting",0,0,0,0,0,0,0.00,
"2011","Barnet","E09000003","Total",356386,172676,183710,352597,3789,6147,8673.72,41.1
"2011","Barnet","E09000003","Urban (total)",356386,172676,183710,352597,3789,6147,8673.72,41.1
"2011","Barnet","E09000003","Urban major conurbation",355633,172300,183333,351847,3786,6109,8203.53,43.4
"2011","Barnet","E09000003","Urban minor conurbation",0,0,0,0,0,0,0.00,
"2011","Barnet","E09000003","Urban city and town",753,376,377,750,3,38,470.19,1.6
"2011","Barnet","E09000003","Urban city and town in a sparse setting",0,0,0,0,0,0,0.00,
"2011","Barnet","E09000003","Rural (total)",0,0,0,0,0,0,0.00,
"2011","Barnet","E09000003","Rural town and fringe",0,0,0,0,0,0,0.00,
"2011","Barnet","E09000003","Rural town and fringe in a sparse setting",0,0,0,0,0,0,0.00,
"2011","Barnet","E09000003","Rural village",0,0,0,0,0,0,0.00,
"2011","Barnet","E09000003","Rural village in a sparse setting",0,0,0,0,0,0,0.00,
"2011","Barnet","E09000003","Rural hamlet and isolated dwellings",0,0,0,0,0,0,0.00,
"2011","Barnet","E09000003","Rural hamlet and isolated dwellings in a sparse setting",0,0,0,0,0,0,0.00,
"2011","Bexley","E09000004","Total",231997,111676,120321,230902,1095,2577,6055.95,38.3
"2011","Bexley","E09000004","Urban (total)",231845,111597,120248,230769,1076,2574,5905.59,39.3
"2011","Bexley","E09000004","Urban major conurbation",231845,111597,120248,230769,1076,2574,5905.59,39.3
"2011","Bexley","E09000004","Urban minor conurbation",0,0,0,0,0,0,0.00,
"2011","Bexley","E09000004","Urban city and town",0,0,0,0,0,0,0.00,
"2011","Bexley","E09000004","Urban city and town in a sparse setting",0,0,0,0,0,0,0.00,
"2011","Bexley","E09000004","Rural (total)",152,79,73,133,19,3,150.36,1.0
"2011","Bexley","E09000004","Rural town and fringe",0,0,0,0,0,0,0.00,
"2011","Bexley","E09000004","Rural town and fringe in a sparse setting",0,0,0,0,0,0,0.00,
"2011","Bexley","E09000004","Rural village",0,0,0,0,0,0,0.00,
"2011","Bexley","E09000004","Rural village in a sparse setting",0,0,0,0,0,0,0.00,
"2011","Bexley","E09000004","Rural hamlet and isolated dwellings",152,79,73,133,19,3,150.36,1.0
"2011","Bexley","E09000004","Rural hamlet and isolated dwellings in a sparse setting",0,0,0,0,0,0,0.00,
"2011","Brent","E09000005","Total",311215,156468,154747,308895,2320,3321,4323.52,72.0
"2011","Brent","E09000005","Urban (total)",311215,156468,154747,308895,2320,3321,4323.52,72.0
"2011","Brent","E09000005","Urban major conurbation",311215,156468,154747,308895,2320,3321,4323.52,72.0
"2011","Brent","E09000005","Urban minor conurbation",0,0,0,0,0,0,0.00,
"2011","Brent","E09000005","Urban city and town",0,0,0,0,0,0,0.00,
"2011","Brent","E09000005","Urban city and town in a sparse setting",0,0,0,0,0,0,0.00,
"2011","Brent","E09000005","Rural (total)",0,0,0,0,0,0,0.00,
"2011","Brent","E09000005","Rural town and fringe",0,0,0,0,0,0,0.00,
"2011","Brent","E09000005","Rural town and fringe in a sparse setting",0,0,0,0,0,0,0.00,
"2011","Brent","E09000005","Rural village",0,0,0,0,0,0,0.00,
"2011","Brent","E09000005","Rural village in a sparse setting",0,0,0,0,0,0,0.00,
"2011","Brent","E09000005","Rural hamlet and isolated dwellings",0,0,0,0,0,0,0.00,
"2011","Brent","E09000005","Rural hamlet and isolated dwellings in a sparse setting",0,0,0,0,0,0,0.00,
"2011","Bromley","E09000006","Total",309392,148588,160804,307023,2369,4757,15015.45,20.6
"2011","Bromley","E09000006","Urban (total)",305937,146884,159053,303578,2359,4697,11290.17,27.1
"2011","Bromley","E09000006","Urban major conurbation",291763,139949,151814,289417,2346,4469,9161.80,31.8
"2011","Bromley","E09000006","Urban minor conurbation",0,0,0,0,0,0,0.00,
"2011","Bromley","E09000006","Urban city and town",14174,6935,7239,14161,13,228,2128.37,6.7
"2011","Bromley","E09000006","Urban city and town in a sparse setting",0,0,0,0,0,0,0.00,
"2011","Bromley","E09000006","Rural (total)",3455,1704,1751,3445,10,60,3725.28,0.9
"2011","Bromley","E09000006","Rural town and fringe",603,298,305,593,10,7,746.80,0.8
"2011","Bromley","E09000006","Rural town and fringe in a sparse setting",0,0,0,0,0,0,0.00,
"2011","Bromley","E09000006","Rural village",1698,857,841,1698,0,32,1340.46,1.3
"2011","Bromley","E09000006","Rural village in a sparse setting",0,0,0,0,0,0,0.00,
"2011","Bromley","E09000006","Rural hamlet and isolated dwellings",1154,549,605,1154,0,21,1638.02,0.7
"2011","Bromley","E09000006","Rural hamlet and isolated dwellings in a sparse setting",0,0,0,0,0,0,0.00,
"2011","Croydon","E09000008","Total",363378,176224,187154,360230,3148,4823,8651.89,42.0
"2011","Croydon","E09000008","Urban (total)",363378,176224,187154,360230,3148,4823,8651.89,42.0
"2011","Croydon","E09000008","Urban major conurbation",363378,176224,187154,360230,3148,4823,8651.89,42.0
"2011","Croydon","E09000008","Urban minor conurbation",0,0,0,0,0,0,0.00,
"2011","Croydon","E09000008","Urban city and town",0,0,0,0,0,0,0.00,
"2011","Croydon","E09000008","Urban city and town in a sparse setting",0,0,0,0,0,0,0.00,
"2011","Croydon","E09000008","Rural (total)",0,0,0,0,0,0,0.00,
"2011","Croydon","E09000008","Rural town and fringe",0,0,0,0,0,0,0.00,
"2011","Croydon","E09000008","Rural town and fringe in a sparse setting",0,0,0,0,0,0,0.00,
"2011","Croydon","E09000008","Rural village",0,0,0,0,0,0,0.00,
"2011","Croydon","E09000008","Rural village in a sparse setting",0,0,0,0,0,0,0.00,
"2011","Croydon","E09000008","Rural hamlet and isolated dwellings",0,0,0,0,0,0,0.00,
"2011","Croydon","E09000008","Rural hamlet and isolated dwellings in a sparse setting",0,0,0,0,0,0,0.00,
"2011","Ealing","E09000009","Total",338449,169175,169274,334725,3724,4037,5552.50,61.0
"2011","Ealing","E09000009","Urban (total)",338449,169175,169274,334725,3724,4037,5552.50,61.0
"2011","Ealing","E09000009","Urban major conurbation",338449,169175,169274,334725,3724,4037,5552.50,61.0
"2011","Ealing","E09000009","Urban minor conurbation",0,0,0,0,0,0,0.00,
"2011","Ealing","E09000009","Urban city and town",0,0,0,0,0,0,0.00,
"2011","Ealing","E09000009","Urban city and town in a sparse setting",0,0,0,0,0,0,0.00,
"2011","Ealing","E09000009","Rural (total)",0,0,0,0,0,0,0.00,
"2011","Ealing","E09000009","Rural town and fringe",0,0,0,0,0,0,0.00,
"2011","Ealing","E09000009","Rural town and fringe in a sparse setting",0,0,0,0,0,0,0.00,
"2011","Ealing","E09000009","Rural village",0,0,0,0,0,0,0.00,
"2011","Ealing","E09000009","Rural village in a sparse setting",0,0,0,0,0,0,0.00,
"2011","Ealing","E09000009","Rural hamlet and isolated dwellings",0,0,0,0,0,0,0.00,
"2011","Ealing","E09000009","Rural hamlet and isolated dwellings in a sparse setting",0,0,0,0,0,0,0.00,
"2011","Enfield","E09000010","Total",312466,150654,161812,310066,2400,3835,8082.94,38.7
"2011","Enfield","E09000010","Urban (total)",310988,149951,161037,308825,2163,3802,6389.72,48.7
"2011","Enfield","E09000010","Urban major conurbation",309171,149045,160126,307045,2126,3736,6089.60,50.8
"2011","Enfield","E09000010","Urban minor conurbation",0,0,0,0,0,0,0.00,
"2011","Enfield","E09000010","Urban city and town",1817,906,911,1780,37,66,300.12,6.1
"2011","Enfield","E09000010","Urban city and town in a sparse setting",0,0,0,0,0,0,0.00,
"2011","Enfield","E09000010","Rural (total)",1478,703,775,1241,237,33,1693.22,0.9
"2011","Enfield","E09000010","Rural town and fringe",0,0,0,0,0,0,0.00,
"2011","Enfield","E09000010","Rural town and fringe in a sparse setting",0,0,0,0,0,0,0.00,
"2011","Enfield","E09000010","Rural village",1064,489,575,827,237,20,467.29,2.3
"2011","Enfield","E09000010","Rural village in a sparse setting",0,0,0,0,0,0,0.00,
"2011","Enfield","E09000010","Rural hamlet and isolated dwellings",414,214,200,414,0,13,1225.93,0.3
"2011","Enfield","E09000010","Rural hamlet and isolated dwellings in a sparse setting",0,0,0,0,0,0,0.00,
"2011","Greenwich","E09000011","Total",254557,126224,128333,249991,4566,2542,4734.38,53.8
"2011","Greenwich","E09000011","Urban (total)",254557,126224,128333,249991,4566,2542,4734.38,53.8
"2011","Greenwich","E09000011","Urban major conurbation",254557,126224,128333,249991,4566,2542,4734.38,53.8
"2011","Greenwich","E09000011","Urban minor conurbation",0,0,0,0,0,0,0.00,
"2011","Greenwich","E09000011","Urban city and town",0,0,0,0,0,0,0.00,
"2011","Greenwich","E09000011","Urban city and town in a sparse setting",0,0,0,0,0,0,0.00,
"2011","Greenwich","E09000011","Rural (total)",0,0,0,0,0,0,0.00,
"2011","Greenwich","E09000011","Rural town and fringe",0,0,0,0,0,0,0.00,
"2011","Greenwich","E09000011","Rural town and fringe in a sparse setting",0,0,0,0,0,0,0.00,
"2011","Greenwich","E09000011","Rural village",0,0,0,0,0,0,0.00,
"2011","Greenwich","E09000011","Rural village in a sparse setting",0,0,0,0,0,0,0.00,
"2011","Greenwich","E09000011","Rural hamlet and isolated dwellings",0,0,0,0,0,0,0.00,
"2011","Greenwich","E09000011","Rural hamlet and isolated dwellings in a sparse setting",0,0,0,0,0,0,0.00,
"2011","Harrow","E09000015","Total",239056,118023,121033,236970,2086,4251,5046.91,47.4
"2011","Harrow","E09000015","Urban (total)",238455,117730,120725,236372,2083,4240,4776.00,49.9
"2011","Harrow","E09000015","Urban major conurbation",238455,117730,120725,236372,2083,4240,4776.00,49.9
"2011","Harrow","E09000015","Urban minor conurbation",0,0,0,0,0,0,0.00,
"2011","Harrow","E09000015","Urban city and town",0,0,0,0,0,0,0.00,
"2011","Harrow","E09000015","Urban city and town in a sparse setting",0,0,0,0,0,0,0.00,
"2011","Harrow","E09000015","Rural (total)",601,293,308,598,3,11,270.91,2.2
"2011","Harrow","E09000015","Rural town and fringe",0,0,0,0,0,0,0.00,
"2011","Harrow","E09000015","Rural town and fringe in a sparse setting",0,0,0,0,0,0,0.00,
"2011","Harrow","E09000015","Rural village",601,293,308,598,3,11,270.91,2.2
"2011","Harrow","E09000015","Rural village in a sparse setting",0,0,0,0,0,0,0.00,
"2011","Harrow","E09000015","Rural hamlet and isolated dwellings",0,0,0,0,0,0,0.00,
"2011","Harrow","E09000015","Rural hamlet and isolated dwellings in a sparse setting",0,0,0,0,0,0,0.00,
"2011","Havering","E09000016","Total",237232,114209,123023,235671,1561,2383,11236.35,21.1
"2011","Havering","E09000016","Urban (total)",235372,113306,122066,233929,1443,2374,7999.77,29.4
"2011","Havering","E09000016","Urban major conurbation",234684,112986,121698,233263,1421,2370,7532.76,31.2
"2011","Havering","E09000016","Urban minor conurbation",0,0,0,0,0,0,0.00,
"2011","Havering","E09000016","Urban city and town",688,320,368,666,22,4,467.01,1.5
"2011","Havering","E09000016","Urban city and town in a sparse setting",0,0,0,0,0,0,0.00,
"2011","Havering","E09000016","Rural (total)",1860,903,957,1742,118,9,3236.58,0.6
"2011","Havering","E09000016","Rural town and fringe",512,245,267,512,0,0,103.91,4.9
"2011","Havering","E09000016","Rural town and fringe in a sparse setting",0,0,0,0,0,0,0.00,
"2011","Havering","E09000016","Rural village",259,125,134,255,4,0,933.22,0.3
"2011","Havering","E09000016","Rural village in a sparse setting",0,0,0,0,0,0,0.00,
"2011","Havering","E09000016","Rural hamlet and isolated dwellings",1089,533,556,975,114,9,2199.45,0.5
"2011","Havering","E09000016","Rural hamlet and isolated dwellings in a sparse setting",0,0,0,0,0,0,0.00,
"2011","Hillingdon","E09000017","Total",273936,135811,138125,267227,6709,3371,11569.87,23.7
"2011","Hillingdon","E09000017","Urban (total)",266537,132246,134291,260046,6491,3304,10047.43,26.5
"2011","Hillingdon","E09000017","Urban major conurbation",263476,130512,132964,257268,6208,3262,8261.37,31.9
"2011","Hillingdon","E09000017","Urban minor conurbation",0,0,0,0,0,0,0.00,
"2011","Hillingdon","E09000017","Urban city and town",3061,1734,1327,2778,283,42,1786.06,1.7
"2011","Hillingdon","E09000017","Urban city and town in a sparse setting",0,0,0,0,0,0,0.00,
"2011","Hillingdon","E09000017","Rural (total)",7399,3565,3834,7181,218,67,1522.44,4.9
"2011","Hillingdon","E09000017","Rural town and fringe",6416,3086,3330,6248,168,51,874.79,7.3
"2011","Hillingdon","E09000017","Rural town and fringe in a sparse setting",0,0,0,0,0,0,0.00,
"2011","Hillingdon","E09000017","Rural village",865,425,440,815,50,9,70.97,12.2
"2011","Hillingdon","E09000017","Rural village in a sparse setting",0,0,0,0,0,0,0.00,
"2011","Hillingdon","E09000017","Rural hamlet and isolated dwellings",118,54,64,118,0,7,576.68,0.2
"2011","Hillingdon","E09000017","Rural hamlet and isolated dwellings in a sparse setting",0,0,0,0,0,0,0.00,
"2011","Hounslow","E09000018","Total",253957,127397,126560,251961,1996,2897,5598.62,45.4
"2011","Hounslow","E09000018","Urban (total)",253957,127397,126560,251961,1996,2897,5598.62,45.4
"2011","Hounslow","E09000018","Urban major conurbation",253957,127397,126560,251961,1996,2897,5598.62,45.4
"2011","Hounslow","E09000018","Urban minor conurbation",0,0,0,0,0,0,0.00,
"2011","Hounslow","E09000018","Urban city and town",0,0,0,0,0,0,0.00,
"2011","Hounslow","E09000018","Urban city and town in a sparse setting",0,0,0,0,0,0,0.00,
"2011","Hounslow","E09000018","Rural (total)",0,0,0,0,0,0,0.00,
"2011","Hounslow","E09000018","Rural town and fringe",0,0,0,0,0,0,0.00,
"2011","Hounslow","E09000018","Rural town and fringe in a sparse setting",0,0,0,0,0,0,0.00,
"2011","Hounslow","E09000018","Rural village",0,0,0,0,0,0,0.00,
"2011","Hounslow","E09000018","Rural village in a sparse setting",0,0,0,0,0,0,0.00,
"2011","Hounslow","E09000018","Rural hamlet and isolated dwellings",0,0,0,0,0,0,0.00,
"2011","Hounslow","E09000018","Rural hamlet and isolated dwellings in a sparse setting",0,0,0,0,0,0,0.00,
"2011","Kingston upon Thames","E09000021","Total",160060,78103,81957,156358,3702,2639,3724.69,43.0
"2011","Kingston upon Thames","E09000021","Urban (total)",159636,77904,81732,155934,3702,2637,3397.38,47.0
"2011","Kingston upon Thames","E09000021","Urban major conurbation",156986,76635,80351,153645,3341,2550,3298.59,47.6
"2011","Kingston upon Thames","E09000021","Urban minor conurbation",0,0,0,0,0,0,0.00,
"2011","Kingston upon Thames","E09000021","Urban city and town",2650,1269,1381,2289,361,87,98.79,26.8
"2011","Kingston upon Thames","E09000021","Urban city and town in a sparse setting",0,0,0,0,0,0,0.00,
"2011","Kingston upon Thames","E09000021","Rural (total)",424,199,225,424,0,2,327.31,1.3
"2011","Kingston upon Thames","E09000021","Rural town and fringe",0,0,0,0,0,0,0.00,
"2011","Kingston upon Thames","E09000021","Rural town and fringe in a sparse setting",0,0,0,0,0,0,0.00,
"2011","Kingston upon Thames","E09000021","Rural village",424,199,225,424,0,2,327.31,1.3
"2011","Kingston upon Thames","E09000021","Rural village in a sparse setting",0,0,0,0,0,0,0.00,
"2011","Kingston upon Thames","E09000021","Rural hamlet and isolated dwellings",0,0,0,0,0,0,0.00,
"2011","Kingston upon Thames","E09000021","Rural hamlet and isolated dwellings in a sparse setting",0,0,0,0,0,0,0.00,
"2011","Merton","E09000024","Total",199693,98515,101178,198217,1476,2866,3760.87,53.1
"2011","Merton","E09000024","Urban (total)",199693,98515,101178,198217,1476,2866,3760.87,53.1
"2011","Merton","E09000024","Urban major conurbation",199693,98515,101178,198217,1476,2866,3760.87,53.1
"2011","Merton","E09000024","Urban minor conurbation",0,0,0,0,0,0,0.00,
"2011","Merton","E09000024","Urban city and town",0,0,0,0,0,0,0.00,
"2011","Merton","E09000024","Urban city and town in a sparse setting",0,0,0,0,0,0,0.00,
"2011","Merton","E09000024","Rural (total)",0,0,0,0,0,0,0.00,
"2011","Merton","E09000024","Rural town and fringe",0,0,0,0,0,0,0.00,
"2011","Merton","E09000024","Rural town and fringe in a sparse setting",0,0,0,0,0,0,0.00,
"2011","Merton","E09000024","Rural village",0,0,0,0,0,0,0.00,
"2011","Merton","E09000024","Rural village in a sparse setting",0,0,0,0,0,0,0.00,
"2011","Merton","E09000024","Rural hamlet and isolated dwellings",0,0,0,0,0,0,0.00,
"2011","Merton","E09000024","Rural hamlet and isolated dwellings in a sparse setting",0,0,0,0,0,0,0.00,
"2011","Redbridge","E09000026","Total",278970,138073,140897,277323,1647,3793,5641.14,49.5
"2011","Redbridge","E09000026","Urban (total)",278970,138073,140897,277323,1647,3793,5641.14,49.5
"2011","Redbridge","E09000026","Urban major conurbation",278970,138073,140897,277323,1647,3793,5641.14,49.5
"2011","Redbridge","E09000026","Urban minor conurbation",0,0,0,0,0,0,0.00,
"2011","Redbridge","E09000026","Urban city and town",0,0,0,0,0,0,0.00,
"2011","Redbridge","E09000026","Urban city and town in a sparse setting",0,0,0,0,0,0,0.00,
"2011","Redbridge","E09000026","Rural (total)",0,0,0,0,0,0,0.00,
"2011","Redbridge","E09000026","Rural town and fringe",0,0,0,0,0,0,0.00,
"2011","Redbridge","E09000026","Rural town and fringe in a sparse setting",0,0,0,0,0,0,0.00,
"2011","Redbridge","E09000026","Rural village",0,0,0,0,0,0,0.00,
"2011","Redbridge","E09000026","Rural village in a sparse setting",0,0,0,0,0,0,0.00,
"2011","Redbridge","E09000026","Rural hamlet and isolated dwellings",0,0,0,0,0,0,0.00,
"2011","Redbridge","E09000026","Rural hamlet and isolated dwellings in a sparse setting",0,0,0,0,0,0,0.00,
"2011","Richmond upon Thames","E09000027","Total",186990,91149,95841,184098,2892,3661,5741.52,32.6
"2011","Richmond upon Thames","E09000027","Urban (total)",186990,91149,95841,184098,2892,3661,5741.52,32.6
"2011","Richmond upon Thames","E09000027","Urban major conurbation",186990,91149,95841,184098,2892,3661,5741.52,32.6
"2011","Richmond upon Thames","E09000027","Urban minor conurbation",0,0,0,0,0,0,0.00,
"2011","Richmond upon Thames","E09000027","Urban city and town",0,0,0,0,0,0,0.00,
"2011","Richmond upon Thames","E09000027","Urban city and town in a sparse setting",0,0,0,0,0,0,0.00,
"2011","Richmond upon Thames","E09000027","Rural (total)",0,0,0,0,0,0,0.00,
"2011","Richmond upon Thames","E09000027","Rural town and fringe",0,0,0,0,0,0,0.00,
"2011","Richmond upon Thames","E09000027","Rural town and fringe in a sparse setting",0,0,0,0,0,0,0.00,
"2011","Richmond upon Thames","E09000027","Rural village",0,0,0,0,0,0,0.00,
"2011","Richmond upon Thames","E09000027","Rural village in a sparse setting",0,0,0,0,0,0,0.00,
"2011","Richmond upon Thames","E09000027","Rural hamlet and isolated dwellings",0,0,0,0,0,0,0.00,
"2011","Richmond upon Thames","E09000027","Rural hamlet and isolated dwellings in a sparse setting",0,0,0,0,0,0,0.00,
"2011","Sutton","E09000029","Total",190146,92443,97703,188695,1451,2587,4385.02,43.4
"2011","Sutton","E09000029","Urban (total)",190146,92443,97703,188695,1451,2587,4385.02,43.4
"2011","Sutton","E09000029","Urban major conurbation",189719,92254,97465,188337,1382,2581,4007.89,47.3
"2011","Sutton","E09000029","Urban minor conurbation",0,0,0,0,0,0,0.00,
"2011","Sutton","E09000029","Urban city and town",427,189,238,358,69,6,377.13,1.1
"2011","Sutton","E09000029","Urban city and town in a sparse setting",0,0,0,0,0,0,0.00,
"2011","Sutton","E09000029","Rural (total)",0,0,0,0,0,0,0.00,
"2011","Sutton","E09000029","Rural town and fringe",0,0,0,0,0,0,0.00,
"2011","Sutton","E09000029","Rural town and fringe in a sparse setting",0,0,0,0,0,0,0.00,
"2011","Sutton","E09000029","Rural village",0,0,0,0,0,0,0.00,
"2011","Sutton","E09000029","Rural village in a sparse setting",0,0,0,0,0,0,0.00,
"2011","Sutton","E09000029","Rural hamlet and isolated dwellings",0,0,0,0,0,0,0.00,
"2011","Sutton","E09000029","Rural hamlet and isolated dwellings in a sparse setting",0,0,0,0,0,0,0.00,
"2011","Waltham Forest","E09000031","Total",258249,128970,129279,256615,1634,2149,3881.40,66.5
"2011","Waltham Forest","E09000031","Urban (total)",258249,128970,129279,256615,1634,2149,3881.40,66.5
"2011","Waltham Forest","E09000031","Urban major conurbation",258249,128970,129279,256615,1634,2149,3881.40,66.5
"2011","Waltham Forest","E09000031","Urban minor conurbation",0,0,0,0,0,0,0.00,
"2011","Waltham Forest","E09000031","Urban city and town",0,0,0,0,0,0,0.00,
"2011","Waltham Forest","E09000031","Urban city and town in a sparse setting",0,0,0,0,0,0,0.00,
"2011","Waltham Forest","E09000031","Rural (total)",0,0,0,0,0,0,0.00,
"2011","Waltham Forest","E09000031","Rural town and fringe",0,0,0,0,0,0,0.00,
"2011","Waltham Forest","E09000031","Rural town and fringe in a sparse setting",0,0,0,0,0,0,0.00,
"2011","Waltham Forest","E09000031","Rural village",0,0,0,0,0,0,0.00,
"2011","Waltham Forest","E09000031","Rural village in a sparse setting",0,0,0,0,0,0,0.00,
"2011","Waltham Forest","E09000031","Rural hamlet and isolated dwellings",0,0,0,0,0,0,0.00,
"2011","Waltham Forest","E09000031","Rural hamlet and isolated dwellings in a sparse setting",0,0,0,0,0,0,0.00,
"2011","Bracknell Forest","E06000036","Total",113205,56107,57098,110512,2693,1811,10938.54,10.3
"2011","Bracknell Forest","E06000036","Urban (total)",110896,54944,55952,108206,2690,1729,8177.53,13.6
"2011","Bracknell Forest","E06000036","Urban major conurbation",0,0,0,0,0,0,0.00,
"2011","Bracknell Forest","E06000036","Urban minor conurbation",0,0,0,0,0,0,0.00,
"2011","Bracknell Forest","E06000036","Urban city and town",110896,54944,55952,108206,2690,1729,8177.53,13.6
"2011","Bracknell Forest","E06000036","Urban city and town in a sparse setting",0,0,0,0,0,0,0.00,
"2011","Bracknell Forest","E06000036","Rural (total)",2309,1163,1146,2306,3,82,2761.01,0.8
"2011","Bracknell Forest","E06000036","Rural town and fringe",106,52,54,106,0,1,123.08,0.9
"2011","Bracknell Forest","E06000036","Rural town and fringe in a sparse setting",0,0,0,0,0,0,0.00,
"2011","Bracknell Forest","E06000036","Rural village",1089,537,552,1089,0,25,881.49,1.2
"2011","Bracknell Forest","E06000036","Rural village in a sparse setting",0,0,0,0,0,0,0.00,
"2011","Bracknell Forest","E06000036","Rural hamlet and isolated dwellings",1114,574,540,1111,3,56,1756.44,0.6
"2011","Bracknell Forest","E06000036","Rural hamlet and isolated dwellings in a sparse setting",0,0,0,0,0,0,0.00,
"2011","Brighton and Hove","E06000043","Total",273369,136108,137261,266059,7310,2749,8266.71,33.1
"2011","Brighton and Hove","E06000043","Urban (total)",269051,134167,134884,265203,3848,2644,7755.22,34.7
"2011","Brighton and Hove","E06000043","Urban major conurbation",0,0,0,0,0,0,0.00,
"2011","Brighton and Hove","E06000043","Urban minor conurbation",0,0,0,0,0,0,0.00,
"2011","Brighton and Hove","E06000043","Urban city and town",269051,134167,134884,265203,3848,2644,7755.22,34.7
"2011","Brighton and Hove","E06000043","Urban city and town in a sparse setting",0,0,0,0,0,0,0.00,
"2011","Brighton and Hove","E06000043","Rural (total)",4318,1941,2377,856,3462,105,511.49,8.4
"2011","Brighton and Hove","E06000043","Rural town and fringe",1004,413,591,361,643,22,158.39,6.3
"2011","Brighton and Hove","E06000043","Rural town and fringe in a sparse setting",0,0,0,0,0,0,0.00,
"2011","Brighton and Hove","E06000043","Rural village",0,0,0,0,0,0,0.00,
"2011","Brighton and Hove","E06000043","Rural village in a sparse setting",0,0,0,0,0,0,0.00,
"2011","Brighton and Hove","E06000043","Rural hamlet and isolated dwellings",3314,1528,1786,495,2819,83,353.10,9.4
"2011","Brighton and Hove","E06000043","Rural hamlet and isolated dwellings in a sparse setting",0,0,0,0,0,0,0.00,
"2011","Isle of Wight","E06000046","Total",138265,67424,70841,133713,4552,1519,38016.10,3.6
"2011","Isle of Wight","E06000046","Urban (total)",93566,46049,47517,90004,3562,969,6671.45,14.0
"2011","Isle of Wight","E06000046","Urban major conurbation",0,0,0,0,0,0,0.00,
"2011","Isle of Wight","E06000046","Urban minor conurbation",0,0,0,0,0,0,0.00,
"2011","Isle of Wight","E06000046","Urban city and town",93566,46049,47517,90004,3562,969,6671.45,14.0
"2011","Isle of Wight","E06000046","Urban city and town in a sparse setting",0,0,0,0,0,0,0.00,
"2011","Isle of Wight","E06000046","Rural (total)",44699,21375,23324,43709,990,550,31344.65,1.4
"2011","Isle of Wight","E06000046","Rural town and fringe",26689,12654,14035,25998,691,308,4007.14,6.7
"2011","Isle of Wight","E06000046","Rural town and fringe in a sparse setting",0,0,0,0,0,0,0.00,
"2011","Isle of Wight","E06000046","Rural village",10008,4803,5205,9905,103,125,6603.38,1.5
"2011","Isle of Wight","E06000046","Rural village in a sparse setting",0,0,0,0,0,0,0.00,
"2011","Isle of Wight","E06000046","Rural hamlet and isolated dwellings",8002,3918,4084,7806,196,117,20734.13,0.4
"2011","Isle of Wight","E06000046","Rural hamlet and isolated dwellings in a sparse setting",0,0,0,0,0,0,0.00,
"2011","Medway","E06000035","Total",263925,130825,133100,259988,3937,2492,19203.31,13.7
"2011","Medway","E06000035","Urban (total)",235468,116810,118658,231631,3837,2205,6419.40,36.7
"2011","Medway","E06000035","Urban major conurbation",0,0,0,0,0,0,0.00,
"2011","Medway","E06000035","Urban minor conurbation",0,0,0,0,0,0,0.00,
"2011","Medway","E06000035","Urban city and town",235468,116810,118658,231631,3837,2205,6419.40,36.7
"2011","Medway","E06000035","Urban city and town in a sparse setting",0,0,0,0,0,0,0.00,
"2011","Medway","E06000035","Rural (total)",28457,14015,14442,28357,100,287,12783.91,2.2
"2011","Medway","E06000035","Rural town and fringe",20741,10202,10539,20719,22,192,4153.92,5.0
"2011","Medway","E06000035","Rural town and fringe in a sparse setting",0,0,0,0,0,0,0.00,
"2011","Medway","E06000035","Rural village",4811,2371,2440,4787,24,49,3218.30,1.5
"2011","Medway","E06000035","Rural village in a sparse setting",0,0,0,0,0,0,0.00,
"2011","Medway","E06000035","Rural hamlet and isolated dwellings",2905,1442,1463,2851,54,46,5411.69,0.5
"2011","Medway","E06000035","Rural hamlet and isolated dwellings in a sparse setting",0,0,0,0,0,0,0.00,
"2011","Milton Keynes","E06000042","Total",248821,123116,125705,246715,2106,3395,30862.53,8.1
"2011","Milton Keynes","E06000042","Urban (total)",227168,112428,114740,225216,1952,2973,9960.56,22.8
"2011","Milton Keynes","E06000042","Urban major conurbation",0,0,0,0,0,0,0.00,
"2011","Milton Keynes","E06000042","Urban minor conurbation",0,0,0,0,0,0,0.00,
"2011","Milton Keynes","E06000042","Urban city and town",227168,112428,114740,225216,1952,2973,9960.56,22.8
"2011","Milton Keynes","E06000042","Urban city and town in a sparse setting",0,0,0,0,0,0,0.00,
"2011","Milton Keynes","E06000042","Rural (total)",21653,10688,10965,21499,154,422,20901.97,1.0
"2011","Milton Keynes","E06000042","Rural town and fringe",11712,5826,5886,11606,106,211,3006.23,3.9
"2011","Milton Keynes","E06000042","Rural town and fringe in a sparse setting",0,0,0,0,0,0,0.00,
"2011","Milton Keynes","E06000042","Rural village",8683,4246,4437,8636,47,176,13523.97,0.6
"2011","Milton Keynes","E06000042","Rural village in a sparse setting",0,0,0,0,0,0,0.00,
"2011","Milton Keynes","E06000042","Rural hamlet and isolated dwellings",1258,616,642,1257,1,35,4371.77,0.3
"2011","Milton Keynes","E06000042","Rural hamlet and isolated dwellings in a sparse setting",0,0,0,0,0,0,0.00,
"2011","Portsmouth","E06000044","Total",205056,103201,101855,200052,5004,1610,4041.14,50.7
"2011","Portsmouth","E06000044","Urban (total)",205056,103201,101855,200052,5004,1610,4041.14,50.7
"2011","Portsmouth","E06000044","Urban major conurbation",0,0,0,0,0,0,0.00,
"2011","Portsmouth","E06000044","Urban minor conurbation",0,0,0,0,0,0,0.00,
"2011","Portsmouth","E06000044","Urban city and town",205056,103201,101855,200052,5004,1610,4041.14,50.7
"2011","Portsmouth","E06000044","Urban city and town in a sparse setting",0,0,0,0,0,0,0.00,
"2011","Portsmouth","E06000044","Rural (total)",0,0,0,0,0,0,0.00,
"2011","Portsmouth","E06000044","Rural town and fringe",0,0,0,0,0,0,0.00,
"2011","Portsmouth","E06000044","Rural town and fringe in a sparse setting",0,0,0,0,0,0,0.00,
"2011","Portsmouth","E06000044","Rural village",0,0,0,0,0,0,0.00,
"2011","Portsmouth","E06000044","Rural village in a sparse setting",0,0,0,0,0,0,0.00,
"2011","Portsmouth","E06000044","Rural hamlet and isolated dwellings",0,0,0,0,0,0,0.00,
"2011","Portsmouth","E06000044","Rural hamlet and isolated dwellings in a sparse setting",0,0,0,0,0,0,0.00,
"2011","Reading","E06000038","Total",155698,77967,77731,151330,4368,1927,4039.86,38.5
"2011","Reading","E06000038","Urban (total)",155230,77704,77526,150862,4368,1923,4006.77,38.7
"2011","Reading","E06000038","Urban major conurbation",0,0,0,0,0,0,0.00,
"2011","Reading","E06000038","Urban minor conurbation",0,0,0,0,0,0,0.00,
"2011","Reading","E06000038","Urban city and town",155230,77704,77526,150862,4368,1923,4006.77,38.7
"2011","Reading","E06000038","Urban city and town in a sparse setting",0,0,0,0,0,0,0.00,
"2011","Reading","E06000038","Rural (total)",468,263,205,468,0,4,33.09,14.1
"2011","Reading","E06000038","Rural town and fringe",468,263,205,468,0,4,33.09,14.1
"2011","Reading","E06000038","Rural town and fringe in a sparse setting",0,0,0,0,0,0,0.00,
"2011","Reading","E06000038","Rural village",0,0,0,0,0,0,0.00,
"2011","Reading","E06000038","Rural village in a sparse setting",0,0,0,0,0,0,0.00,
"2011","Reading","E06000038","Rural hamlet and isolated dwellings",0,0,0,0,0,0,0.00,
"2011","Reading","E06000038","Rural hamlet and isolated dwellings in a sparse setting",0,0,0,0,0,0,0.00,
"2011","Slough","E06000039","Total",140205,70120,70085,139697,508,1442,3253.61,43.1
"2011","Slough","E06000039","Urban (total)",140205,70120,70085,139697,508,1442,3253.61,43.1
"2011","Slough","E06000039","Urban major conurbation",0,0,0,0,0,0,0.00,
"2011","Slough","E06000039","Urban minor conurbation",0,0,0,0,0,0,0.00,
"2011","Slough","E06000039","Urban city and town",140205,70120,70085,139697,508,1442,3253.61,43.1
"2011","Slough","E06000039","Urban city and town in a sparse setting",0,0,0,0,0,0,0.00,
"2011","Slough","E06000039","Rural (total)",0,0,0,0,0,0,0.00,
"2011","Slough","E06000039","Rural town and fringe",0,0,0,0,0,0,0.00,
"2011","Slough","E06000039","Rural town and fringe in a sparse setting",0,0,0,0,0,0,0.00,
"2011","Slough","E06000039","Rural village",0,0,0,0,0,0,0.00,
"2011","Slough","E06000039","Rural village in a sparse setting",0,0,0,0,0,0,0.00,
"2011","Slough","E06000039","Rural hamlet and isolated dwellings",0,0,0,0,0,0,0.00,
"2011","Slough","E06000039","Rural hamlet and isolated dwellings in a sparse setting",0,0,0,0,0,0,0.00,
"2011","Southampton","E06000045","Total",236882,119453,117429,228459,8423,1886,4988.93,47.5
"2011","Southampton","E06000045","Urban (total)",236882,119453,117429,228459,8423,1886,4988.93,47.5
"2011","Southampton","E06000045","Urban major conurbation",0,0,0,0,0,0,0.00,
"2011","Southampton","E06000045","Urban minor conurbation",0,0,0,0,0,0,0.00,
"2011","Southampton","E06000045","Urban city and town",236882,119453,117429,228459,8423,1886,4988.93,47.5
"2011","Southampton","E06000045","Urban city and town in a sparse setting",0,0,0,0,0,0,0.00,
"2011","Southampton","E06000045","Rural (total)",0,0,0,0,0,0,0.00,
"2011","Southampton","E06000045","Rural town and fringe",0,0,0,0,0,0,0.00,
"2011","Southampton","E06000045","Rural town and fringe in a sparse setting",0,0,0,0,0,0,0.00,
"2011","Southampton","E06000045","Rural village",0,0,0,0,0,0,0.00,
"2011","Southampton","E06000045","Rural village in a sparse setting",0,0,0,0,0,0,0.00,
"2011","Southampton","E06000045","Rural hamlet and isolated dwellings",0,0,0,0,0,0,0.00,
"2011","Southampton","E06000045","Rural hamlet and isolated dwellings in a sparse setting",0,0,0,0,0,0,0.00,
"2011","West Berkshire","E06000037","Total",153822,76321,77501,150878,2944,3036,70416.82,2.2
"2011","West Berkshire","E06000037","Urban (total)",96873,47802,49071,95713,1160,1588,7267.67,13.3
"2011","West Berkshire","E06000037","Urban major conurbation",0,0,0,0,0,0,0.00,
"2011","West Berkshire","E06000037","Urban minor conurbation",0,0,0,0,0,0,0.00,
"2011","West Berkshire","E06000037","Urban city and town",96873,47802,49071,95713,1160,1588,7267.67,13.3
"2011","West Berkshire","E06000037","Urban city and town in a sparse setting",0,0,0,0,0,0,0.00,
"2011","West Berkshire","E06000037","Rural (total)",56949,28519,28430,55165,1784,1448,63149.15,0.9
"2011","West Berkshire","E06000037","Rural town and fringe",23776,11695,12081,23634,142,411,2075.88,11.5
"2011","West Berkshire","E06000037","Rural town and fringe in a sparse setting",0,0,0,0,0,0,0.00,
"2011","West Berkshire","E06000037","Rural village",19513,9918,9595,18589,924,555,21789.69,0.9
"2011","West Berkshire","E06000037","Rural village in a sparse setting",0,0,0,0,0,0,0.00,
"2011","West Berkshire","E06000037","Rural hamlet and isolated dwellings",13660,6906,6754,12942,718,482,39283.58,0.3
"2011","West Berkshire","E06000037","Rural hamlet and isolated dwellings in a sparse setting",0,0,0,0,0,0,0.00,
"2011","Windsor and Maidenhead","E06000040","Total",144560,71328,73232,141065,3495,2991,19650.96,7.4
"2011","Windsor and Maidenhead","E06000040","Urban (total)",129599,63948,65651,126256,3343,2650,10871.89,11.9
"2011","Windsor and Maidenhead","E06000040","Urban major conurbation",389,197,192,389,0,4,42.28,9.2
"2011","Windsor and Maidenhead","E06000040","Urban minor conurbation",0,0,0,0,0,0,0.00,
"2011","Windsor and Maidenhead","E06000040","Urban city and town",129210,63751,65459,125867,3343,2646,10829.61,11.9
"2011","Windsor and Maidenhead","E06000040","Urban city and town in a sparse setting",0,0,0,0,0,0,0.00,
"2011","Windsor and Maidenhead","E06000040","Rural (total)",14961,7380,7581,14809,152,341,8779.07,1.7
"2011","Windsor and Maidenhead","E06000040","Rural town and fringe",6849,3361,3488,6785,64,114,833.73,8.2
"2011","Windsor and Maidenhead","E06000040","Rural town and fringe in a sparse setting",0,0,0,0,0,0,0.00,
"2011","Windsor and Maidenhead","E06000040","Rural village",6153,3029,3124,6086,67,164,4635.89,1.3
"2011","Windsor and Maidenhead","E06000040","Rural village in a sparse setting",0,0,0,0,0,0,0.00,
"2011","Windsor and Maidenhead","E06000040","Rural hamlet and isolated dwellings",1959,990,969,1938,21,63,3309.45,0.6
"2011","Windsor and Maidenhead","E06000040","Rural hamlet and isolated dwellings in a sparse setting",0,0,0,0,0,0,0.00,
"2011","Wokingham","E06000041","Total",154380,76464,77916,151740,2640,3358,17897.92,8.6
"2011","Wokingham","E06000041","Urban (total)",127335,62951,64384,125341,1994,2721,7067.43,18.0
"2011","Wokingham","E06000041","Urban major conurbation",0,0,0,0,0,0,0.00,
"2011","Wokingham","E06000041","Urban minor conurbation",0,0,0,0,0,0,0.00,
"2011","Wokingham","E06000041","Urban city and town",127335,62951,64384,125341,1994,2721,7067.43,18.0
"2011","Wokingham","E06000041","Urban city and town in a sparse setting",0,0,0,0,0,0,0.00,
"2011","Wokingham","E06000041","Rural (total)",27045,13513,13532,26399,646,637,10830.49,2.5
"2011","Wokingham","E06000041","Rural town and fringe",16218,7975,8243,16107,111,333,1310.39,12.4
"2011","Wokingham","E06000041","Rural town and fringe in a sparse setting",0,0,0,0,0,0,0.00,
"2011","Wokingham","E06000041","Rural village",5226,2648,2578,5182,44,141,2239.92,2.3
"2011","Wokingham","E06000041","Rural village in a sparse setting",0,0,0,0,0,0,0.00,
"2011","Wokingham","E06000041","Rural hamlet and isolated dwellings",5601,2890,2711,5110,491,163,7280.18,0.8
"2011","Wokingham","E06000041","Rural hamlet and isolated dwellings in a sparse setting",0,0,0,0,0,0,0.00,
"2011","Buckinghamshire","E10000002","Total",505283,248346,256937,497299,7984,10771,156494.89,3.2
"2011","Buckinghamshire","E10000002","Urban (total)",339543,166829,172714,334508,5035,6476,26815.30,12.7
"2011","Buckinghamshire","E10000002","Urban major conurbation",1446,746,700,1446,0,23,411.99,3.5
"2011","Buckinghamshire","E10000002","Urban minor conurbation",0,0,0,0,0,0,0.00,
"2011","Buckinghamshire","E10000002","Urban city and town",338097,166083,172014,333062,5035,6453,26403.31,12.8
"2011","Buckinghamshire","E10000002","Urban city and town in a sparse setting",0,0,0,0,0,0,0.00,
"2011","Buckinghamshire","E10000002","Rural (total)",165740,81517,84223,162791,2949,4295,129679.59,1.3
"2011","Buckinghamshire","E10000002","Rural town and fringe",82743,40160,42583,82139,604,1713,12316.60,6.7
"2011","Buckinghamshire","E10000002","Rural town and fringe in a sparse setting",0,0,0,0,0,0,0.00,
"2011","Buckinghamshire","E10000002","Rural village",55845,27837,28008,54879,966,1612,55874.01,1.0
"2011","Buckinghamshire","E10000002","Rural village in a sparse setting",0,0,0,0,0,0,0.00,
"2011","Buckinghamshire","E10000002","Rural hamlet and isolated dwellings",27152,13520,13632,25773,1379,970,61488.98,0.4
"2011","Buckinghamshire","E10000002","Rural hamlet and isolated dwellings in a sparse setting",0,0,0,0,0,0,0.00,
"2011","East Sussex","E10000011","Total",526671,253764,272907,515598,11073,7111,170855.38,3.1
"2011","East Sussex","E10000011","Urban (total)",389946,187529,202417,382480,7466,4011,22988.17,17.0
"2011","East Sussex","E10000011","Urban major conurbation",0,0,0,0,0,0,0.00,
"2011","East Sussex","E10000011","Urban minor conurbation",0,0,0,0,0,0,0.00,
"2011","East Sussex","E10000011","Urban city and town",389946,187529,202417,382480,7466,4011,22988.17,17.0
"2011","East Sussex","E10000011","Urban city and town in a sparse setting",0,0,0,0,0,0,0.00,
"2011","East Sussex","E10000011","Rural (total)",136725,66235,70490,133118,3607,3100,147867.21,0.9
"2011","East Sussex","E10000011","Rural town and fringe",48728,23269,25459,47866,862,770,9355.36,5.2
"2011","East Sussex","E10000011","Rural town and fringe in a sparse setting",0,0,0,0,0,0,0.00,
"2011","East Sussex","E10000011","Rural village",51147,24755,26392,49616,1531,1075,47399.27,1.1
"2011","East Sussex","E10000011","Rural village in a sparse setting",0,0,0,0,0,0,0.00,
"2011","East Sussex","E10000011","Rural hamlet and isolated dwellings",36850,18211,18639,35636,1214,1255,91112.58,0.4
"2011","East Sussex","E10000011","Rural hamlet and isolated dwellings in a sparse setting",0,0,0,0,0,0,0.00,
"2011","Hampshire","E10000014","Total",1317788,644938,672850,1296211,21577,20446,367894.90,3.6
"2011","Hampshire","E10000014","Urban (total)",1029336,502914,526422,1016394,12942,13109,62551.10,16.5
"2011","Hampshire","E10000014","Urban major conurbation",0,0,0,0,0,0,0.00,
"2011","Hampshire","E10000014","Urban minor conurbation",0,0,0,0,0,0,0.00,
"2011","Hampshire","E10000014","Urban city and town",1029336,502914,526422,1016394,12942,13109,62551.10,16.5
"2011","Hampshire","E10000014","Urban city and town in a sparse setting",0,0,0,0,0,0,0.00,
"2011","Hampshire","E10000014","Rural (total)",288452,142024,146428,279817,8635,7337,305343.80,0.9
"2011","Hampshire","E10000014","Rural town and fringe",140624,68550,72074,137523,3101,2517,19146.88,7.3
"2011","Hampshire","E10000014","Rural town and fringe in a sparse setting",0,0,0,0,0,0,0.00,
"2011","Hampshire","E10000014","Rural village",84029,41583,42446,81074,2955,2450,84868.83,1.0
"2011","Hampshire","E10000014","Rural village in a sparse setting",0,0,0,0,0,0,0.00,
"2011","Hampshire","E10000014","Rural hamlet and isolated dwellings",63799,31891,31908,61220,2579,2370,201328.09,0.3
"2011","Hampshire","E10000014","Rural hamlet and isolated dwellings in a sparse setting",0,0,0,0,0,0,0.00,
"2011","Kent","E10000016","Total",1463740,715613,748127,1435745,27995,19074,354352.64,4.1
"2011","Kent","E10000016","Urban (total)",1058640,517103,541537,1038145,20495,12090,56651.20,18.7
"2011","Kent","E10000016","Urban major conurbation",183535,90535,93000,182236,1299,1759,7116.36,25.8
"2011","Kent","E10000016","Urban minor conurbation",0,0,0,0,0,0,0.00,
"2011","Kent","E10000016","Urban city and town",875105,426568,448537,855909,19196,10331,49534.84,17.7
"2011","Kent","E10000016","Urban city and town in a sparse setting",0,0,0,0,0,0,0.00,
"2011","Kent","E10000016","Rural (total)",405100,198510,206590,397600,7500,6984,297701.44,1.4
"2011","Kent","E10000016","Rural town and fringe",203648,98697,104951,201316,2332,2517,28990.63,7.0
"2011","Kent","E10000016","Rural town and fringe in a sparse setting",0,0,0,0,0,0,0.00,
"2011","Kent","E10000016","Rural village",117361,57769,59592,114518,2843,2281,88447.80,1.3
"2011","Kent","E10000016","Rural village in a sparse setting",0,0,0,0,0,0,0.00,
"2011","Kent","E10000016","Rural hamlet and isolated dwellings",84091,42044,42047,81766,2325,2186,180263.01,0.5
"2011","Kent","E10000016","Rural hamlet and isolated dwellings in a sparse setting",0,0,0,0,0,0,0.00,
"2011","Oxfordshire","E10000025","Total",653798,322971,330827,624099,29699,12177,260491.51,2.5
"2011","Oxfordshire","E10000025","Urban (total)",435201,214594,220607,412291,22910,6586,26707.33,16.3
"2011","Oxfordshire","E10000025","Urban major conurbation",0,0,0,0,0,0,0.00,
"2011","Oxfordshire","E10000025","Urban minor conurbation",0,0,0,0,0,0,0.00,
"2011","Oxfordshire","E10000025","Urban city and town",435201,214594,220607,412291,22910,6586,26707.33,16.3
"2011","Oxfordshire","E10000025","Urban city and town in a sparse setting",0,0,0,0,0,0,0.00,
"2011","Oxfordshire","E10000025","Rural (total)",218597,108377,110220,211808,6789,5591,233784.18,0.9
"2011","Oxfordshire","E10000025","Rural town and fringe",101280,49695,51585,98743,2537,1958,21706.41,4.7
"2011","Oxfordshire","E10000025","Rural town and fringe in a sparse setting",0,0,0,0,0,0,0.00,
"2011","Oxfordshire","E10000025","Rural village",91571,45337,46234,89276,2295,2623,131305.09,0.7
"2011","Oxfordshire","E10000025","Rural village in a sparse setting",0,0,0,0,0,0,0.00,
"2011","Oxfordshire","E10000025","Rural hamlet and isolated dwellings",25746,13345,12401,23789,1957,1010,80772.68,0.3
"2011","Oxfordshire","E10000025","Rural hamlet and isolated dwellings in a sparse setting",0,0,0,0,0,0,0.00,
"2011","Surrey","E10000030","Total",1132390,554665,577725,1105800,26590,21694,166249.81,6.8
"2011","Surrey","E10000030","Urban (total)",980249,480566,499683,958798,21451,17808,65810.22,14.9
"2011","Surrey","E10000030","Urban major conurbation",551737,269800,281937,542290,9447,9297,26073.53,21.2
"2011","Surrey","E10000030","Urban minor conurbation",0,0,0,0,0,0,0.00,
"2011","Surrey","E10000030","Urban city and town",428512,210766,217746,416508,12004,8511,39736.69,10.8
"2011","Surrey","E10000030","Urban city and town in a sparse setting",0,0,0,0,0,0,0.00,
"2011","Surrey","E10000030","Rural (total)",152141,74099,78042,147002,5139,3886,100439.59,1.5
"2011","Surrey","E10000030","Rural town and fringe",64916,31602,33314,63705,1211,1194,8438.80,7.7
"2011","Surrey","E10000030","Rural town and fringe in a sparse setting",0,0,0,0,0,0,0.00,
"2011","Surrey","E10000030","Rural village",47629,23139,24490,46194,1435,1331,27827.76,1.7
"2011","Surrey","E10000030","Rural village in a sparse setting",0,0,0,0,0,0,0.00,
"2011","Surrey","E10000030","Rural hamlet and isolated dwellings",39596,19358,20238,37103,2493,1361,64173.03,0.6
"2011","Surrey","E10000030","Rural hamlet and isolated dwellings in a sparse setting",0,0,0,0,0,0,0.00,
"2011","West Sussex","E10000032","Total",806892,390567,416325,791540,15352,11487,199049.35,4.1
"2011","West Sussex","E10000032","Urban (total)",615318,297188,318130,606209,9109,7074,28770.03,21.4
"2011","West Sussex","E10000032","Urban major conurbation",0,0,0,0,0,0,0.00,
"2011","West Sussex","E10000032","Urban minor conurbation",0,0,0,0,0,0,0.00,
"2011","West Sussex","E10000032","Urban city and town",615318,297188,318130,606209,9109,7074,28770.03,21.4
"2011","West Sussex","E10000032","Urban city and town in a sparse setting",0,0,0,0,0,0,0.00,
"2011","West Sussex","E10000032","Rural (total)",191574,93379,98195,185331,6243,4413,170279.32,1.1
"2011","West Sussex","E10000032","Rural town and fringe",101262,48462,52800,100202,1060,1719,16582.25,6.1
"2011","West Sussex","E10000032","Rural town and fringe in a sparse setting",0,0,0,0,0,0,0.00,
"2011","West Sussex","E10000032","Rural village",47936,23857,24079,45446,2490,1191,46513.73,1.0
"2011","West Sussex","E10000032","Rural village in a sparse setting",0,0,0,0,0,0,0.00,
"2011","West Sussex","E10000032","Rural hamlet and isolated dwellings",42376,21060,21316,39683,2693,1503,107183.34,0.4
"2011","West Sussex","E10000032","Rural hamlet and isolated dwellings in a sparse setting",0,0,0,0,0,0,0.00,
"2011","Bath and North East Somerset","E06000022","Total",176016,86072,89944,169977,6039,2937,34574.08,5.1
"2011","Bath and North East Somerset","E06000022","Urban (total)",138913,67815,71098,133879,5034,2166,8546.36,16.3
"2011","Bath and North East Somerset","E06000022","Urban major conurbation",0,0,0,0,0,0,0.00,
"2011","Bath and North East Somerset","E06000022","Urban minor conurbation",0,0,0,0,0,0,0.00,
"2011","Bath and North East Somerset","E06000022","Urban city and town",138913,67815,71098,133879,5034,2166,8546.36,16.3
"2011","Bath and North East Somerset","E06000022","Urban city and town in a sparse setting",0,0,0,0,0,0,0.00,
"2011","Bath and North East Somerset","E06000022","Rural (total)",37103,18257,18846,36098,1005,771,26027.72,1.4
"2011","Bath and North East Somerset","E06000022","Rural town and fringe",16057,7907,8150,15807,250,238,1705.05,9.4
"2011","Bath and North East Somerset","E06000022","Rural town and fringe in a sparse setting",0,0,0,0,0,0,0.00,
"2011","Bath and North East Somerset","E06000022","Rural village",16551,8128,8423,15843,708,404,13610.28,1.2
"2011","Bath and North East Somerset","E06000022","Rural village in a sparse setting",0,0,0,0,0,0,0.00,
"2011","Bath and North East Somerset","E06000022","Rural hamlet and isolated dwellings",4495,2222,2273,4448,47,129,10712.39,0.4
"2011","Bath and North East Somerset","E06000022","Rural hamlet and isolated dwellings in a sparse setting",0,0,0,0,0,0,0.00,
"2011","Bournemouth","E06000028","Total",183491,91386,92105,179138,4353,1785,4617.88,39.7
"2011","Bournemouth","E06000028","Urban (total)",183352,91319,92033,178999,4353,1782,4560.46,40.2
"2011","Bournemouth","E06000028","Urban major conurbation",0,0,0,0,0,0,0.00,
"2011","Bournemouth","E06000028","Urban minor conurbation",0,0,0,0,0,0,0.00,
"2011","Bournemouth","E06000028","Urban city and town",183352,91319,92033,178999,4353,1782,4560.46,40.2
"2011","Bournemouth","E06000028","Urban city and town in a sparse setting",0,0,0,0,0,0,0.00,
"2011","Bournemouth","E06000028","Rural (total)",139,67,72,139,0,3,57.42,2.4
"2011","Bournemouth","E06000028","Rural town and fringe",0,0,0,0,0,0,0.00,
"2011","Bournemouth","E06000028","Rural town and fringe in a sparse setting",0,0,0,0,0,0,0.00,
"2011","Bournemouth","E06000028","Rural village",0,0,0,0,0,0,0.00,
"2011","Bournemouth","E06000028","Rural village in a sparse setting",0,0,0,0,0,0,0.00,
"2011","Bournemouth","E06000028","Rural hamlet and isolated dwellings",139,67,72,139,0,3,57.42,2.4
"2011","Bournemouth","E06000028","Rural hamlet and isolated dwellings in a sparse setting",0,0,0,0,0,0,0.00,
"2011","Bristol, City of","E06000023","Total",428234,213071,215163,418814,9420,3927,10960.76,39.1
"2011","Bristol, City of","E06000023","Urban (total)",428234,213071,215163,418814,9420,3927,10960.76,39.1
"2011","Bristol, City of","E06000023","Urban major conurbation",0,0,0,0,0,0,0.00,
"2011","Bristol, City of","E06000023","Urban minor conurbation",0,0,0,0,0,0,0.00,
"2011","Bristol, City of","E06000023","Urban city and town",428234,213071,215163,418814,9420,3927,10960.76,39.1
"2011","Bristol, City of","E06000023","Urban city and town in a sparse setting",0,0,0,0,0,0,0.00,
"2011","Bristol, City of","E06000023","Rural (total)",0,0,0,0,0,0,0.00,
"2011","Bristol, City of","E06000023","Rural town and fringe",0,0,0,0,0,0,0.00,
"2011","Bristol, City of","E06000023","Rural town and fringe in a sparse setting",0,0,0,0,0,0,0.00,
"2011","Bristol, City of","E06000023","Rural village",0,0,0,0,0,0,0.00,
"2011","Bristol, City of","E06000023","Rural village in a sparse setting",0,0,0,0,0,0,0.00,
"2011","Bristol, City of","E06000023","Rural hamlet and isolated dwellings",0,0,0,0,0,0,0.00,
"2011","Bristol, City of","E06000023","Rural hamlet and isolated dwellings in a sparse setting",0,0,0,0,0,0,0.00,
"2011","Cornwall","E06000052","Total",532273,257805,274468,523432,8841,6106,354618.74,1.5
"2011","Cornwall","E06000052","Urban (total)",205591,99342,106249,201302,4289,2121,13580.69,15.1
"2011","Cornwall","E06000052","Urban major conurbation",0,0,0,0,0,0,0.00,
"2011","Cornwall","E06000052","Urban minor conurbation",0,0,0,0,0,0,0.00,
"2011","Cornwall","E06000052","Urban city and town",205591,99342,106249,201302,4289,2121,13580.69,15.1
"2011","Cornwall","E06000052","Urban city and town in a sparse setting",0,0,0,0,0,0,0.00,
"2011","Cornwall","E06000052","Rural (total)",326682,158463,168219,322130,4552,3985,341038.05,1.0
"2011","Cornwall","E06000052","Rural town and fringe",120849,57914,62935,119560,1289,1204,12896.15,9.4
"2011","Cornwall","E06000052","Rural town and fringe in a sparse setting",25211,12100,13111,24689,522,298,2545.38,9.9
"2011","Cornwall","E06000052","Rural village",81684,39610,42074,80695,989,998,59159.91,1.4
"2011","Cornwall","E06000052","Rural village in a sparse setting",19889,9613,10276,19291,598,237,20892.96,1.0
"2011","Cornwall","E06000052","Rural hamlet and isolated dwellings",65004,32214,32790,64203,801,1042,177854.10,0.4
"2011","Cornwall","E06000052","Rural hamlet and isolated dwellings in a sparse setting",14045,7012,7033,13692,353,206,67689.55,0.2
"2011","Isles of Scilly","E06000053","Total",2203,1102,1101,2123,80,79,1637.47,1.3
"2011","Isles of Scilly","E06000053","Urban (total)",0,0,0,0,0,0,0.00,
"2011","Isles of Scilly","E06000053","Urban major conurbation",0,0,0,0,0,0,0.00,
"2011","Isles of Scilly","E06000053","Urban minor conurbation",0,0,0,0,0,0,0.00,
"2011","Isles of Scilly","E06000053","Urban city and town",0,0,0,0,0,0,0.00,
"2011","Isles of Scilly","E06000053","Urban city and town in a sparse setting",0,0,0,0,0,0,0.00,
"2011","Isles of Scilly","E06000053","Rural (total)",2203,1102,1101,2123,80,79,1637.47,1.3
"2011","Isles of Scilly","E06000053","Rural town and fringe",0,0,0,0,0,0,0.00,
"2011","Isles of Scilly","E06000053","Rural town and fringe in a sparse setting",0,0,0,0,0,0,0.00,
"2011","Isles of Scilly","E06000053","Rural village",0,0,0,0,0,0,0.00,
"2011","Isles of Scilly","E06000053","Rural village in a sparse setting",2067,1036,1031,1990,77,75,1361.92,1.5
"2011","Isles of Scilly","E06000053","Rural hamlet and isolated dwellings",0,0,0,0,0,0,0.00,
"2011","Isles of Scilly","E06000053","Rural hamlet and isolated dwellings in a sparse setting",136,66,70,133,3,4,275.55,0.5
"2011","North Somerset","E06000024","Total",202566,98463,104103,199225,3341,2727,37378.60,5.4
"2011","North Somerset","E06000024","Urban (total)",165328,80274,85054,162464,2864,2010,9101.49,18.2
"2011","North Somerset","E06000024","Urban major conurbation",0,0,0,0,0,0,0.00,
"2011","North Somerset","E06000024","Urban minor conurbation",0,0,0,0,0,0,0.00,
"2011","North Somerset","E06000024","Urban city and town",165328,80274,85054,162464,2864,2010,9101.49,18.2
"2011","North Somerset","E06000024","Urban city and town in a sparse setting",0,0,0,0,0,0,0.00,
"2011","North Somerset","E06000024","Rural (total)",37238,18189,19049,36761,477,717,28277.11,1.3
"2011","North Somerset","E06000024","Rural town and fringe",13494,6522,6972,13458,36,229,1861.58,7.2
"2011","North Somerset","E06000024","Rural town and fringe in a sparse setting",0,0,0,0,0,0,0.00,
"2011","North Somerset","E06000024","Rural village",15563,7612,7951,15356,207,296,10730.45,1.5
"2011","North Somerset","E06000024","Rural village in a sparse setting",0,0,0,0,0,0,0.00,
"2011","North Somerset","E06000024","Rural hamlet and isolated dwellings",8181,4055,4126,7947,234,192,15685.08,0.5
"2011","North Somerset","E06000024","Rural hamlet and isolated dwellings in a sparse setting",0,0,0,0,0,0,0.00,
"2011","Plymouth","E06000026","Total",256384,126684,129700,251100,5284,1978,7983.36,32.1
"2011","Plymouth","E06000026","Urban (total)",256384,126684,129700,251100,5284,1978,7983.36,32.1
"2011","Plymouth","E06000026","Urban major conurbation",0,0,0,0,0,0,0.00,
"2011","Plymouth","E06000026","Urban minor conurbation",0,0,0,0,0,0,0.00,
"2011","Plymouth","E06000026","Urban city and town",256384,126684,129700,251100,5284,1978,7983.36,32.1
"2011","Plymouth","E06000026","Urban city and town in a sparse setting",0,0,0,0,0,0,0.00,
"2011","Plymouth","E06000026","Rural (total)",0,0,0,0,0,0,0.00,
"2011","Plymouth","E06000026","Rural town and fringe",0,0,0,0,0,0,0.00,
"2011","Plymouth","E06000026","Rural town and fringe in a sparse setting",0,0,0,0,0,0,0.00,
"2011","Plymouth","E06000026","Rural village",0,0,0,0,0,0,0.00,
"2011","Plymouth","E06000026","Rural village in a sparse setting",0,0,0,0,0,0,0.00,
"2011","Plymouth","E06000026","Rural hamlet and isolated dwellings",0,0,0,0,0,0,0.00,
"2011","Plymouth","E06000026","Rural hamlet and isolated dwellings in a sparse setting",0,0,0,0,0,0,0.00,
"2011","Poole","E06000029","Total",147645,72121,75524,145103,2542,1718,6475.33,22.8
"2011","Poole","E06000029","Urban (total)",147409,71992,75417,144867,2542,1709,6223.63,23.7
"2011","Poole","E06000029","Urban major conurbation",0,0,0,0,0,0,0.00,
"2011","Poole","E06000029","Urban minor conurbation",0,0,0,0,0,0,0.00,
"2011","Poole","E06000029","Urban city and town",147409,71992,75417,144867,2542,1709,6223.63,23.7
"2011","Poole","E06000029","Urban city and town in a sparse setting",0,0,0,0,0,0,0.00,
"2011","Poole","E06000029","Rural (total)",236,129,107,236,0,9,251.70,0.9
"2011","Poole","E06000029","Rural town and fringe",0,0,0,0,0,0,0.00,
"2011","Poole","E06000029","Rural town and fringe in a sparse setting",0,0,0,0,0,0,0.00,
"2011","Poole","E06000029","Rural village",0,0,0,0,0,0,0.00,
"2011","Poole","E06000029","Rural village in a sparse setting",0,0,0,0,0,0,0.00,
"2011","Poole","E06000029","Rural hamlet and isolated dwellings",236,129,107,236,0,9,251.70,0.9
"2011","Poole","E06000029","Rural hamlet and isolated dwellings in a sparse setting",0,0,0,0,0,0,0.00,
"2011","South Gloucestershire","E06000025","Total",262767,130424,132343,258207,4560,2948,49694.56,5.3
"2011","South Gloucestershire","E06000025","Urban (total)",228404,113171,115233,224904,3500,2313,10992.24,20.8
"2011","South Gloucestershire","E06000025","Urban major conurbation",0,0,0,0,0,0,0.00,
"2011","South Gloucestershire","E06000025","Urban minor conurbation",0,0,0,0,0,0,0.00,
"2011","South Gloucestershire","E06000025","Urban city and town",228404,113171,115233,224904,3500,2313,10992.24,20.8
"2011","South Gloucestershire","E06000025","Urban city and town in a sparse setting",0,0,0,0,0,0,0.00,
"2011","South Gloucestershire","E06000025","Rural (total)",34363,17253,17110,33303,1060,635,38702.32,0.9
"2011","South Gloucestershire","E06000025","Rural town and fringe",13612,6771,6841,13416,196,176,2096.48,6.5
"2011","South Gloucestershire","E06000025","Rural town and fringe in a sparse setting",0,0,0,0,0,0,0.00,
"2011","South Gloucestershire","E06000025","Rural village",12117,5882,6235,11811,306,264,11630.20,1.0
"2011","South Gloucestershire","E06000025","Rural village in a sparse setting",0,0,0,0,0,0,0.00,
"2011","South Gloucestershire","E06000025","Rural hamlet and isolated dwellings",8634,4600,4034,8076,558,195,24975.64,0.3
"2011","South Gloucestershire","E06000025","Rural hamlet and isolated dwellings in a sparse setting",0,0,0,0,0,0,0.00,
"2011","Swindon","E06000030","Total",209156,104618,104538,207858,1298,2098,23010.36,9.1
"2011","Swindon","E06000030","Urban (total)",185308,92995,92313,184352,956,1699,7790.37,23.8
"2011","Swindon","E06000030","Urban major conurbation",0,0,0,0,0,0,0.00,
"2011","Swindon","E06000030","Urban minor conurbation",0,0,0,0,0,0,0.00,
"2011","Swindon","E06000030","Urban city and town",185308,92995,92313,184352,956,1699,7790.37,23.8
"2011","Swindon","E06000030","Urban city and town in a sparse setting",0,0,0,0,0,0,0.00,
"2011","Swindon","E06000030","Rural (total)",23848,11623,12225,23506,342,399,15219.99,1.6
"2011","Swindon","E06000030","Rural town and fringe",18927,9143,9784,18764,163,264,2438.67,7.8
"2011","Swindon","E06000030","Rural town and fringe in a sparse setting",0,0,0,0,0,0,0.00,
"2011","Swindon","E06000030","Rural village",3385,1700,1685,3251,134,101,5387.07,0.6
"2011","Swindon","E06000030","Rural village in a sparse setting",0,0,0,0,0,0,0.00,
"2011","Swindon","E06000030","Rural hamlet and isolated dwellings",1536,780,756,1491,45,34,7394.25,0.2
"2011","Swindon","E06000030","Rural hamlet and isolated dwellings in a sparse setting",0,0,0,0,0,0,0.00,
"2011","Torbay","E06000027","Total",130959,63110,67849,127908,3051,1265,6287.40,20.8
"2011","Torbay","E06000027","Urban (total)",130197,62715,67482,127146,3051,1252,5472.09,23.8
"2011","Torbay","E06000027","Urban major conurbation",0,0,0,0,0,0,0.00,
"2011","Torbay","E06000027","Urban minor conurbation",0,0,0,0,0,0,0.00,
"2011","Torbay","E06000027","Urban city and town",130197,62715,67482,127146,3051,1252,5472.09,23.8
"2011","Torbay","E06000027","Urban city and town in a sparse setting",0,0,0,0,0,0,0.00,
"2011","Torbay","E06000027","Rural (total)",762,395,367,762,0,13,815.31,0.9
"2011","Torbay","E06000027","Rural town and fringe",0,0,0,0,0,0,0.00,
"2011","Torbay","E06000027","Rural town and fringe in a sparse setting",0,0,0,0,0,0,0.00,
"2011","Torbay","E06000027","Rural village",460,244,216,460,0,6,467.71,1.0
"2011","Torbay","E06000027","Rural village in a sparse setting",0,0,0,0,0,0,0.00,
"2011","Torbay","E06000027","Rural hamlet and isolated dwellings",302,151,151,302,0,7,347.60,0.9
"2011","Torbay","E06000027","Rural hamlet and isolated dwellings in a sparse setting",0,0,0,0,0,0,0.00,
"2011","Wiltshire","E06000054","Total",470981,231754,239227,457954,13027,9360,325534.12,1.4
"2011","Wiltshire","E06000054","Urban (total)",247262,120260,127002,243773,3489,3679,18883.79,13.1
"2011","Wiltshire","E06000054","Urban major conurbation",0,0,0,0,0,0,0.00,
"2011","Wiltshire","E06000054","Urban minor conurbation",0,0,0,0,0,0,0.00,
"2011","Wiltshire","E06000054","Urban city and town",247262,120260,127002,243773,3489,3679,18883.79,13.1
"2011","Wiltshire","E06000054","Urban city and town in a sparse setting",0,0,0,0,0,0,0.00,
"2011","Wiltshire","E06000054","Rural (total)",223719,111494,112225,214181,9538,5681,306650.33,0.7
"2011","Wiltshire","E06000054","Rural town and fringe",87894,43427,44467,84593,3301,1630,18186.69,4.8
"2011","Wiltshire","E06000054","Rural town and fringe in a sparse setting",0,0,0,0,0,0,0.00,
"2011","Wiltshire","E06000054","Rural village",95036,47383,47653,91324,3712,2655,151878.81,0.6
"2011","Wiltshire","E06000054","Rural village in a sparse setting",0,0,0,0,0,0,0.00,
"2011","Wiltshire","E06000054","Rural hamlet and isolated dwellings",40789,20684,20105,38264,2525,1396,136584.83,0.3
"2011","Wiltshire","E06000054","Rural hamlet and isolated dwellings in a sparse setting",0,0,0,0,0,0,0.00,
"2011","Devon","E10000008","Total",746399,361745,384654,727737,18662,10616,656421.67,1.1
"2011","Devon","E10000008","Urban (total)",362368,174183,188185,351989,10379,4168,23970.34,15.1
"2011","Devon","E10000008","Urban major conurbation",0,0,0,0,0,0,0.00,
"2011","Devon","E10000008","Urban minor conurbation",0,0,0,0,0,0,0.00,
"2011","Devon","E10000008","Urban city and town",351184,168754,182430,341205,9979,4066,22960.09,15.3
"2011","Devon","E10000008","Urban city and town in a sparse setting",11184,5429,5755,10784,400,102,1010.25,11.1
"2011","Devon","E10000008","Rural (total)",384031,187562,196469,375748,8283,6448,632451.33,0.6
"2011","Devon","E10000008","Rural town and fringe",155391,74120,81271,153117,2274,2111,19735.17,7.9
"2011","Devon","E10000008","Rural town and fringe in a sparse setting",25417,12264,13153,24863,554,265,5368.09,4.7
"2011","Devon","E10000008","Rural village",78456,38492,39964,76644,1812,1428,91664.50,0.9
"2011","Devon","E10000008","Rural village in a sparse setting",16886,8299,8587,16787,99,247,27066.80,0.6
"2011","Devon","E10000008","Rural hamlet and isolated dwellings",79990,40458,39532,77008,2982,1879,314666.96,0.3
"2011","Devon","E10000008","Rural hamlet and isolated dwellings in a sparse setting",27891,13929,13962,27329,562,518,173949.81,0.2
"2011","Dorset","E10000009","Total",412905,201271,211634,403366,9539,6281,254162.16,1.6
"2011","Dorset","E10000009","Urban (total)",244328,118033,126295,241208,3120,2990,19279.19,12.7
"2011","Dorset","E10000009","Urban major conurbation",0,0,0,0,0,0,0.00,
"2011","Dorset","E10000009","Urban minor conurbation",0,0,0,0,0,0,0.00,
"2011","Dorset","E10000009","Urban city and town",244328,118033,126295,241208,3120,2990,19279.19,12.7
"2011","Dorset","E10000009","Urban city and town in a sparse setting",0,0,0,0,0,0,0.00,
"2011","Dorset","E10000009","Rural (total)",168577,83238,85339,162158,6419,3291,234882.97,0.7
"2011","Dorset","E10000009","Rural town and fringe",72615,35150,37465,70314,2301,992,12214.06,5.9
"2011","Dorset","E10000009","Rural town and fringe in a sparse setting",274,122,152,245,29,6,66.12,4.1
"2011","Dorset","E10000009","Rural village",63362,31641,31721,61023,2339,1395,96791.36,0.7
"2011","Dorset","E10000009","Rural village in a sparse setting",0,0,0,0,0,0,0.00,
"2011","Dorset","E10000009","Rural hamlet and isolated dwellings",32326,16325,16001,30576,1750,898,125811.43,0.3
"2011","Dorset","E10000009","Rural hamlet and isolated dwellings in a sparse setting",0,0,0,0,0,0,0.00,
"2011","Gloucestershire","E10000013","Total",596984,292586,304398,586018,10966,9279,265324.94,2.3
"2011","Gloucestershire","E10000013","Urban (total)",419967,206106,213861,412580,7387,5537,32371.07,13.0
"2011","Gloucestershire","E10000013","Urban major conurbation",0,0,0,0,0,0,0.00,
"2011","Gloucestershire","E10000013","Urban minor conurbation",0,0,0,0,0,0,0.00,
"2011","Gloucestershire","E10000013","Urban city and town",419967,206106,213861,412580,7387,5537,32371.07,13.0
"2011","Gloucestershire","E10000013","Urban city and town in a sparse setting",0,0,0,0,0,0,0.00,
"2011","Gloucestershire","E10000013","Rural (total)",177017,86480,90537,173438,3579,3742,232953.87,0.8
"2011","Gloucestershire","E10000013","Rural town and fringe",68772,33052,35720,68131,641,1049,12865.90,5.3
"2011","Gloucestershire","E10000013","Rural town and fringe in a sparse setting",0,0,0,0,0,0,0.00,
"2011","Gloucestershire","E10000013","Rural village",69212,34197,35015,68275,937,1507,100102.10,0.7
"2011","Gloucestershire","E10000013","Rural village in a sparse setting",0,0,0,0,0,0,0.00,
"2011","Gloucestershire","E10000013","Rural hamlet and isolated dwellings",39033,19231,19802,37032,2001,1186,119985.87,0.3
"2011","Gloucestershire","E10000013","Rural hamlet and isolated dwellings in a sparse setting",0,0,0,0,0,0,0.00,
"2011","Somerset","E10000027","Total",529972,258396,271576,517124,12848,8053,345054.82,1.5
"2011","Somerset","E10000027","Urban (total)",274709,133343,141366,267734,6975,3135,16177.40,17.0
"2011","Somerset","E10000027","Urban major conurbation",0,0,0,0,0,0,0.00,
"2011","Somerset","E10000027","Urban minor conurbation",0,0,0,0,0,0,0.00,
"2011","Somerset","E10000027","Urban city and town",262728,127708,135020,256900,5828,3040,15041.58,17.5
"2011","Somerset","E10000027","Urban city and town in a sparse setting",11981,5635,6346,10834,1147,95,1135.82,10.5
"2011","Somerset","E10000027","Rural (total)",255263,125053,130210,249390,5873,4918,328877.42,0.8
"2011","Somerset","E10000027","Rural town and fringe",99111,47701,51410,97712,1399,1355,18063.31,5.5
"2011","Somerset","E10000027","Rural town and fringe in a sparse setting",2069,965,1104,2026,43,13,385.33,5.4
"2011","Somerset","E10000027","Rural village",90644,44763,45881,88194,2450,1940,92894.40,1.0
"2011","Somerset","E10000027","Rural village in a sparse setting",2346,1087,1259,2326,20,33,6179.06,0.4
"2011","Somerset","E10000027","Rural hamlet and isolated dwellings",56432,28277,28155,54539,1893,1488,168049.24,0.3
"2011","Somerset","E10000027","Rural hamlet and isolated dwellings in a sparse setting",4661,2260,2401,4593,68,89,43306.08,0.1
"2011","Anglesey","W06000001","Total",69751,34274,35477,68941,810,848,71124.11,1.0
"2011","Anglesey","W06000001","Urban (total)",11431,5685,5746,11361,70,79,668.52,17.1
"2011","Anglesey","W06000001","Urban major conurbation",0,0,0,0,0,0,0.00,
"2011","Anglesey","W06000001","Urban minor conurbation",0,0,0,0,0,0,0.00,
"2011","Anglesey","W06000001","Urban city and town",0,0,0,0,0,0,0.00,
"2011","Anglesey","W06000001","Urban city and town in a sparse setting",11431,5685,5746,11361,70,79,668.52,17.1
"2011","Anglesey","W06000001","Rural (total)",58320,28589,29731,57580,740,769,70455.59,0.8
"2011","Anglesey","W06000001","Rural town and fringe",11802,5709,6093,11635,167,179,1801.04,6.6
"2011","Anglesey","W06000001","Rural town and fringe in a sparse setting",12277,5900,6377,12168,109,133,3252.81,3.8
"2011","Anglesey","W06000001","Rural village",8420,4112,4308,8266,154,125,11661.22,0.7
"2011","Anglesey","W06000001","Rural village in a sparse setting",15329,7635,7694,15071,258,173,16820.21,0.9
"2011","Anglesey","W06000001","Rural hamlet and isolated dwellings",2744,1348,1396,2720,24,65,7685.73,0.4
"2011","Anglesey","W06000001","Rural hamlet and isolated dwellings in a sparse setting",7748,3885,3863,7720,28,94,29234.58,0.3
"2011","Gwynedd","W06000002","Total",121874,59906,61968,117974,3900,1771,253493.94,0.5
"2011","Gwynedd","W06000002","Urban (total)",17988,8845,9143,15288,2700,272,980.45,18.3
"2011","Gwynedd","W06000002","Urban major conurbation",0,0,0,0,0,0,0.00,
"2011","Gwynedd","W06000002","Urban minor conurbation",0,0,0,0,0,0,0.00,
"2011","Gwynedd","W06000002","Urban city and town",17988,8845,9143,15288,2700,272,980.45,18.3
"2011","Gwynedd","W06000002","Urban city and town in a sparse setting",0,0,0,0,0,0,0.00,
"2011","Gwynedd","W06000002","Rural (total)",103886,51061,52825,102686,1200,1499,252513.49,0.4
"2011","Gwynedd","W06000002","Rural town and fringe",20950,10276,10674,20759,191,254,3065.42,6.8
"2011","Gwynedd","W06000002","Rural town and fringe in a sparse setting",26753,12973,13780,26280,473,353,7103.94,3.8
"2011","Gwynedd","W06000002","Rural village",10480,5138,5342,10409,71,132,11074.35,0.9
"2011","Gwynedd","W06000002","Rural village in a sparse setting",29585,14477,15108,29340,245,458,78615.30,0.4
"2011","Gwynedd","W06000002","Rural hamlet and isolated dwellings",4311,2137,2174,4231,80,89,11755.17,0.4
"2011","Gwynedd","W06000002","Rural hamlet and isolated dwellings in a sparse setting",11807,6060,5747,11667,140,213,140899.31,0.1
"2011","Conwy","W06000003","Total",115228,55749,59479,112531,2697,1520,112582.88,1.0
"2011","Conwy","W06000003","Urban (total)",79469,38166,41303,77175,2294,996,6385.10,12.4
"2011","Conwy","W06000003","Urban major conurbation",0,0,0,0,0,0,0.00,
"2011","Conwy","W06000003","Urban minor conurbation",0,0,0,0,0,0,0.00,
"2011","Conwy","W06000003","Urban city and town",79469,38166,41303,77175,2294,996,6385.10,12.4
"2011","Conwy","W06000003","Urban city and town in a sparse setting",0,0,0,0,0,0,0.00,
"2011","Conwy","W06000003","Rural (total)",35759,17583,18176,35356,403,524,106197.78,0.3
"2011","Conwy","W06000003","Rural town and fringe",15083,7347,7736,14893,190,201,3249.94,4.6
"2011","Conwy","W06000003","Rural town and fringe in a sparse setting",3323,1563,1760,3268,55,22,524.42,6.3
"2011","Conwy","W06000003","Rural village",6071,2972,3099,6063,8,83,13337.23,0.5
"2011","Conwy","W06000003","Rural village in a sparse setting",2340,1161,1179,2337,3,36,15799.03,0.1
"2011","Conwy","W06000003","Rural hamlet and isolated dwellings",5341,2678,2663,5294,47,116,29594.68,0.2
"2011","Conwy","W06000003","Rural hamlet and isolated dwellings in a sparse setting",3601,1862,1739,3501,100,66,43692.48,0.1
"2011","Denbighshire","W06000004","Total",93734,45987,47747,92483,1251,1211,83674.27,1.1
"2011","Denbighshire","W06000004","Urban (total)",46267,22505,23762,46098,169,434,2849.52,16.2
"2011","Denbighshire","W06000004","Urban major conurbation",0,0,0,0,0,0,0.00,
"2011","Denbighshire","W06000004","Urban minor conurbation",0,0,0,0,0,0,0.00,
"2011","Denbighshire","W06000004","Urban city and town",46267,22505,23762,46098,169,434,2849.52,16.2
"2011","Denbighshire","W06000004","Urban city and town in a sparse setting",0,0,0,0,0,0,0.00,
"2011","Denbighshire","W06000004","Rural (total)",47467,23482,23985,46385,1082,777,80824.75,0.6
"2011","Denbighshire","W06000004","Rural town and fringe",25623,12547,13076,25064,559,344,3533.45,7.3
"2011","Denbighshire","W06000004","Rural town and fringe in a sparse setting",0,0,0,0,0,0,0.00,
"2011","Denbighshire","W06000004","Rural village",11037,5445,5592,10677,360,194,30511.53,0.4
"2011","Denbighshire","W06000004","Rural village in a sparse setting",2787,1425,1362,2775,12,46,13005.97,0.2
"2011","Denbighshire","W06000004","Rural hamlet and isolated dwellings",8020,4065,3955,7869,151,193,33773.80,0.2
"2011","Denbighshire","W06000004","Rural hamlet and isolated dwellings in a sparse setting",0,0,0,0,0,0,0.00,
"2011","Flintshire","W06000005","Total",152506,75247,77259,151679,827,1719,43753.91,3.5
"2011","Flintshire","W06000005","Urban (total)",105208,51857,53351,104644,564,1054,11333.98,9.3
"2011","Flintshire","W06000005","Urban major conurbation",0,0,0,0,0,0,0.00,
"2011","Flintshire","W06000005","Urban minor conurbation",0,0,0,0,0,0,0.00,
"2011","Flintshire","W06000005","Urban city and town",105208,51857,53351,104644,564,1054,11333.98,9.3
"2011","Flintshire","W06000005","Urban city and town in a sparse setting",0,0,0,0,0,0,0.00,
"2011","Flintshire","W06000005","Rural (total)",47298,23390,23908,47035,263,665,32419.93,1.5
"2011","Flintshire","W06000005","Rural town and fringe",19730,9736,9994,19641,89,221,2466.50,8.0
"2011","Flintshire","W06000005","Rural town and fringe in a sparse setting",0,0,0,0,0,0,0.00,
"2011","Flintshire","W06000005","Rural village",21291,10478,10813,21168,123,295,15390.91,1.4
"2011","Flintshire","W06000005","Rural village in a sparse setting",0,0,0,0,0,0,0.00,
"2011","Flintshire","W06000005","Rural hamlet and isolated dwellings",6277,3176,3101,6226,51,149,14562.52,0.4
"2011","Flintshire","W06000005","Rural hamlet and isolated dwellings in a sparse setting",0,0,0,0,0,0,0.00,
"2011","Wrexham","W06000006","Total",134844,67052,67792,133244,1600,1370,50377.45,2.7
"2011","Wrexham","W06000006","Urban (total)",91054,45311,45743,90047,1007,753,7765.45,11.7
"2011","Wrexham","W06000006","Urban major conurbation",0,0,0,0,0,0,0.00,
"2011","Wrexham","W06000006","Urban minor conurbation",0,0,0,0,0,0,0.00,
"2011","Wrexham","W06000006","Urban city and town",91054,45311,45743,90047,1007,753,7765.45,11.7
"2011","Wrexham","W06000006","Urban city and town in a sparse setting",0,0,0,0,0,0,0.00,
"2011","Wrexham","W06000006","Rural (total)",43790,21741,22049,43197,593,617,42612.00,1.0
"2011","Wrexham","W06000006","Rural town and fringe",24963,12254,12709,24458,505,294,3957.44,6.3
"2011","Wrexham","W06000006","Rural town and fringe in a sparse setting",0,0,0,0,0,0,0.00,
"2011","Wrexham","W06000006","Rural village",10583,5278,5305,10548,35,155,8657.03,1.2
"2011","Wrexham","W06000006","Rural village in a sparse setting",0,0,0,0,0,0,0.00,
"2011","Wrexham","W06000006","Rural hamlet and isolated dwellings",7927,4039,3888,7876,51,167,24587.98,0.3
"2011","Wrexham","W06000006","Rural hamlet and isolated dwellings in a sparse setting",317,170,147,315,2,1,5409.55,0.1
"2011","Powys","W06000023","Total",132976,65683,67293,131047,1929,2117,518037.01,0.3
"2011","Powys","W06000023","Urban (total)",17911,8732,9179,17650,261,178,6190.18,2.9
"2011","Powys","W06000023","Urban major conurbation",0,0,0,0,0,0,0.00,
"2011","Powys","W06000023","Urban minor conurbation",0,0,0,0,0,0,0.00,
"2011","Powys","W06000023","Urban city and town",6554,3172,3382,6424,130,51,3481.59,1.9
"2011","Powys","W06000023","Urban city and town in a sparse setting",11357,5560,5797,11226,131,127,2708.59,4.2
"2011","Powys","W06000023","Rural (total)",115065,56951,58114,113397,1668,1939,511846.83,0.2
"2011","Powys","W06000023","Rural town and fringe",2981,1423,1558,2929,52,49,257.48,11.6
"2011","Powys","W06000023","Rural town and fringe in a sparse setting",34025,16495,17530,33174,851,467,5553.79,6.1
"2011","Powys","W06000023","Rural village",9821,4855,4966,9635,186,167,28326.00,0.3
"2011","Powys","W06000023","Rural village in a sparse setting",30862,15231,15631,30658,204,472,113211.88,0.3
"2011","Powys","W06000023","Rural hamlet and isolated dwellings",3781,1928,1853,3677,104,85,41565.95,0.1
"2011","Powys","W06000023","Rural hamlet and isolated dwellings in a sparse setting",33595,17019,16576,33324,271,699,322931.73,0.1
"2011","Ceredigion","W06000008","Total",75922,37793,38129,71444,4478,1203,178545.43,0.4
"2011","Ceredigion","W06000008","Urban (total)",18749,9583,9166,15258,3491,264,1133.40,16.5
"2011","Ceredigion","W06000008","Urban major conurbation",0,0,0,0,0,0,0.00,
"2011","Ceredigion","W06000008","Urban minor conurbation",0,0,0,0,0,0,0.00,
"2011","Ceredigion","W06000008","Urban city and town",0,0,0,0,0,0,0.00,
"2011","Ceredigion","W06000008","Urban city and town in a sparse setting",18749,9583,9166,15258,3491,264,1133.40,16.5
"2011","Ceredigion","W06000008","Rural (total)",57173,28210,28963,56186,987,939,177412.03,0.3
"2011","Ceredigion","W06000008","Rural town and fringe",0,0,0,0,0,0,0.00,
"2011","Ceredigion","W06000008","Rural town and fringe in a sparse setting",11689,5719,5970,11071,618,185,2422.34,4.8
"2011","Ceredigion","W06000008","Rural village",0,0,0,0,0,0,0.00,
"2011","Ceredigion","W06000008","Rural village in a sparse setting",27644,13554,14090,27416,228,455,82880.57,0.3
"2011","Ceredigion","W06000008","Rural hamlet and isolated dwellings",0,0,0,0,0,0,0.00,
"2011","Ceredigion","W06000008","Rural hamlet and isolated dwellings in a sparse setting",17840,8937,8903,17699,141,299,92109.12,0.2
"2011","Pembrokeshire","W06000009","Total",122439,59823,62616,120545,1894,1728,161873.87,0.8
"2011","Pembrokeshire","W06000009","Urban (total)",28178,13639,14539,28024,154,308,2883.99,9.8
"2011","Pembrokeshire","W06000009","Urban major conurbation",0,0,0,0,0,0,0.00,
"2011","Pembrokeshire","W06000009","Urban minor conurbation",0,0,0,0,0,0,0.00,
"2011","Pembrokeshire","W06000009","Urban city and town",28178,13639,14539,28024,154,308,2883.99,9.8
"2011","Pembrokeshire","W06000009","Urban city and town in a sparse setting",0,0,0,0,0,0,0.00,
"2011","Pembrokeshire","W06000009","Rural (total)",94261,46184,48077,92521,1740,1420,158989.88,0.6
"2011","Pembrokeshire","W06000009","Rural town and fringe",21753,10594,11159,21471,282,230,1700.27,12.8
"2011","Pembrokeshire","W06000009","Rural town and fringe in a sparse setting",17662,8474,9188,17334,328,242,3299.73,5.4
"2011","Pembrokeshire","W06000009","Rural village",10684,5170,5514,10614,70,184,13165.91,0.8
"2011","Pembrokeshire","W06000009","Rural village in a sparse setting",19278,9389,9889,19098,180,301,25390.44,0.8
"2011","Pembrokeshire","W06000009","Rural hamlet and isolated dwellings",6334,3165,3169,6217,117,125,24611.09,0.3
"2011","Pembrokeshire","W06000009","Rural hamlet and isolated dwellings in a sparse setting",18550,9392,9158,17787,763,338,90822.44,0.2
"2011","Carmarthenshire","W06000010","Total",183777,89837,93940,181227,2550,2254,237035.46,0.8
"2011","Carmarthenshire","W06000010","Urban (total)",89154,43153,46001,87562,1592,922,9760.65,9.1
"2011","Carmarthenshire","W06000010","Urban major conurbation",0,0,0,0,0,0,0.00,
"2011","Carmarthenshire","W06000010","Urban minor conurbation",0,0,0,0,0,0,0.00,
"2011","Carmarthenshire","W06000010","Urban city and town",73300,35688,37612,72371,929,703,7896.92,9.3
"2011","Carmarthenshire","W06000010","Urban city and town in a sparse setting",15854,7465,8389,15191,663,219,1863.73,8.5
"2011","Carmarthenshire","W06000010","Rural (total)",94623,46684,47939,93665,958,1332,227274.81,0.4
"2011","Carmarthenshire","W06000010","Rural town and fringe",24932,12058,12874,24781,151,234,4307.66,5.8
"2011","Carmarthenshire","W06000010","Rural town and fringe in a sparse setting",4127,1997,2130,3904,223,61,1799.16,2.3
"2011","Carmarthenshire","W06000010","Rural village",15378,7612,7766,15279,99,203,15531.58,1.0
"2011","Carmarthenshire","W06000010","Rural village in a sparse setting",16545,8091,8454,16358,187,234,27000.26,0.6
"2011","Carmarthenshire","W06000010","Rural hamlet and isolated dwellings",14502,7261,7241,14362,140,274,51121.83,0.3
"2011","Carmarthenshire","W06000010","Rural hamlet and isolated dwellings in a sparse setting",19139,9665,9474,18981,158,326,127514.32,0.2
"2011","Swansea","W06000011","Total",239023,118087,120936,234363,4660,2558,37974.42,6.3
"2011","Swansea","W06000011","Urban (total)",210418,104169,106249,206170,4248,2155,11572.64,18.2
"2011","Swansea","W06000011","Urban major conurbation",0,0,0,0,0,0,0.00,
"2011","Swansea","W06000011","Urban minor conurbation",0,0,0,0,0,0,0.00,
"2011","Swansea","W06000011","Urban city and town",210418,104169,106249,206170,4248,2155,11572.64,18.2
"2011","Swansea","W06000011","Urban city and town in a sparse setting",0,0,0,0,0,0,0.00,
"2011","Swansea","W06000011","Rural (total)",28605,13918,14687,28193,412,403,26401.78,1.1
"2011","Swansea","W06000011","Rural town and fringe",13088,6300,6788,12996,92,179,1890.93,6.9
"2011","Swansea","W06000011","Rural town and fringe in a sparse setting",0,0,0,0,0,0,0.00,
"2011","Swansea","W06000011","Rural village",8522,4170,4352,8425,97,107,5359.73,1.6
"2011","Swansea","W06000011","Rural village in a sparse setting",0,0,0,0,0,0,0.00,
"2011","Swansea","W06000011","Rural hamlet and isolated dwellings",6995,3448,3547,6772,223,117,19151.12,0.4
"2011","Swansea","W06000011","Rural hamlet and isolated dwellings in a sparse setting",0,0,0,0,0,0,0.00,
"2011","Neath Port Talbot","W06000012","Total",139812,68450,71362,138682,1130,1192,44125.95,3.2
"2011","Neath Port Talbot","W06000012","Urban (total)",106074,51781,54293,105135,939,923,11320.24,9.4
"2011","Neath Port Talbot","W06000012","Urban major conurbation",0,0,0,0,0,0,0.00,
"2011","Neath Port Talbot","W06000012","Urban minor conurbation",0,0,0,0,0,0,0.00,
"2011","Neath Port Talbot","W06000012","Urban city and town",106074,51781,54293,105135,939,923,11320.24,9.4
"2011","Neath Port Talbot","W06000012","Urban city and town in a sparse setting",0,0,0,0,0,0,0.00,
"2011","Neath Port Talbot","W06000012","Rural (total)",33738,16669,17069,33547,191,269,32805.71,1.0
"2011","Neath Port Talbot","W06000012","Rural town and fringe",21033,10314,10719,20934,99,169,10487.18,2.0
"2011","Neath Port Talbot","W06000012","Rural town and fringe in a sparse setting",0,0,0,0,0,0,0.00,
"2011","Neath Port Talbot","W06000012","Rural village",10142,5075,5067,10097,45,78,15795.04,0.6
"2011","Neath Port Talbot","W06000012","Rural village in a sparse setting",0,0,0,0,0,0,0.00,
"2011","Neath Port Talbot","W06000012","Rural hamlet and isolated dwellings",2563,1280,1283,2516,47,22,6523.49,0.4
"2011","Neath Port Talbot","W06000012","Rural hamlet and isolated dwellings in a sparse setting",0,0,0,0,0,0,0.00,
"2011","Bridgend","W06000013","Total",139178,68789,70389,136842,2336,1501,25074.74,5.6
"2011","Bridgend","W06000013","Urban (total)",106641,52060,54581,105859,782,1240,8886.59,12.0
"2011","Bridgend","W06000013","Urban major conurbation",0,0,0,0,0,0,0.00,
"2011","Bridgend","W06000013","Urban minor conurbation",0,0,0,0,0,0,0.00,
"2011","Bridgend","W06000013","Urban city and town",106641,52060,54581,105859,782,1240,8886.59,12.0
"2011","Bridgend","W06000013","Urban city and town in a sparse setting",0,0,0,0,0,0,0.00,
"2011","Bridgend","W06000013","Rural (total)",32537,16729,15808,30983,1554,261,16188.15,2.0
"2011","Bridgend","W06000013","Rural town and fringe",24756,12887,11869,23347,1409,179,5426.58,4.6
"2011","Bridgend","W06000013","Rural town and fringe in a sparse setting",0,0,0,0,0,0,0.00,
"2011","Bridgend","W06000013","Rural village",6313,3106,3207,6168,145,52,4934.12,1.3
"2011","Bridgend","W06000013","Rural village in a sparse setting",0,0,0,0,0,0,0.00,
"2011","Bridgend","W06000013","Rural hamlet and isolated dwellings",1468,736,732,1468,0,30,5827.45,0.3
"2011","Bridgend","W06000013","Rural hamlet and isolated dwellings in a sparse setting",0,0,0,0,0,0,0.00,
"2011","The Vale of Glamorgan","W06000014","Total",126336,61522,64814,124259,2077,1857,33095.28,3.8
"2011","The Vale of Glamorgan","W06000014","Urban (total)",101808,49481,52327,100166,1642,1259,7677.76,13.3
"2011","The Vale of Glamorgan","W06000014","Urban major conurbation",0,0,0,0,0,0,0.00,
"2011","The Vale of Glamorgan","W06000014","Urban minor conurbation",0,0,0,0,0,0,0.00,
"2011","The Vale of Glamorgan","W06000014","Urban city and town",101808,49481,52327,100166,1642,1259,7677.76,13.3
"2011","The Vale of Glamorgan","W06000014","Urban city and town in a sparse setting",0,0,0,0,0,0,0.00,
"2011","The Vale of Glamorgan","W06000014","Rural (total)",24528,12041,12487,24093,435,598,25417.52,1.0
"2011","The Vale of Glamorgan","W06000014","Rural town and fringe",8956,4325,4631,8937,19,148,1455.67,6.2
"2011","The Vale of Glamorgan","W06000014","Rural town and fringe in a sparse setting",0,0,0,0,0,0,0.00,
"2011","The Vale of Glamorgan","W06000014","Rural village",13682,6750,6932,13266,416,401,19127.54,0.7
"2011","The Vale of Glamorgan","W06000014","Rural village in a sparse setting",0,0,0,0,0,0,0.00,
"2011","The Vale of Glamorgan","W06000014","Rural hamlet and isolated dwellings",1890,966,924,1890,0,49,4834.31,0.4
"2011","The Vale of Glamorgan","W06000014","Rural hamlet and isolated dwellings in a sparse setting",0,0,0,0,0,0,0.00,
"2011","Cardiff","W06000015","Total",346090,169893,176197,334551,11539,3917,14038.20,24.7
"2011","Cardiff","W06000015","Urban (total)",340177,167012,173165,328691,11486,3717,11420.37,29.8
"2011","Cardiff","W06000015","Urban major conurbation",0,0,0,0,0,0,0.00,
"2011","Cardiff","W06000015","Urban minor conurbation",0,0,0,0,0,0,0.00,
"2011","Cardiff","W06000015","Urban city and town",340177,167012,173165,328691,11486,3717,11420.37,29.8
"2011","Cardiff","W06000015","Urban city and town in a sparse setting",0,0,0,0,0,0,0.00,
"2011","Cardiff","W06000015","Rural (total)",5913,2881,3032,5860,53,200,2617.83,2.3
"2011","Cardiff","W06000015","Rural town and fringe",4667,2259,2408,4648,19,160,1196.01,3.9
"2011","Cardiff","W06000015","Rural town and fringe in a sparse setting",0,0,0,0,0,0,0.00,
"2011","Cardiff","W06000015","Rural village",1246,622,624,1212,34,40,1421.82,0.9
"2011","Cardiff","W06000015","Rural village in a sparse setting",0,0,0,0,0,0,0.00,
"2011","Cardiff","W06000015","Rural hamlet and isolated dwellings",0,0,0,0,0,0,0.00,
"2011","Cardiff","W06000015","Rural hamlet and isolated dwellings in a sparse setting",0,0,0,0,0,0,0.00,
"2011","Rhondda, Cynon, Taff","W06000016","Total",234410,114635,119775,231885,2525,1881,42412.97,5.5
"2011","Rhondda, Cynon, Taff","W06000016","Urban (total)",175566,85848,89718,173390,2176,1425,21497.26,8.2
"2011","Rhondda, Cynon, Taff","W06000016","Urban major conurbation",0,0,0,0,0,0,0.00,
"2011","Rhondda, Cynon, Taff","W06000016","Urban minor conurbation",0,0,0,0,0,0,0.00,
"2011","Rhondda, Cynon, Taff","W06000016","Urban city and town",175566,85848,89718,173390,2176,1425,21497.26,8.2
"2011","Rhondda, Cynon, Taff","W06000016","Urban city and town in a sparse setting",0,0,0,0,0,0,0.00,
"2011","Rhondda, Cynon, Taff","W06000016","Rural (total)",58844,28787,30057,58495,349,456,20915.71,2.8
"2011","Rhondda, Cynon, Taff","W06000016","Rural town and fringe",52073,25450,26623,51815,258,383,7729.56,6.7
"2011","Rhondda, Cynon, Taff","W06000016","Rural town and fringe in a sparse setting",0,0,0,0,0,0,0.00,
"2011","Rhondda, Cynon, Taff","W06000016","Rural village",3477,1741,1736,3433,44,31,8306.42,0.4
"2011","Rhondda, Cynon, Taff","W06000016","Rural village in a sparse setting",0,0,0,0,0,0,0.00,
"2011","Rhondda, Cynon, Taff","W06000016","Rural hamlet and isolated dwellings",3294,1596,1698,3247,47,42,4879.73,0.7
"2011","Rhondda, Cynon, Taff","W06000016","Rural hamlet and isolated dwellings in a sparse setting",0,0,0,0,0,0,0.00,
"2011","Merthyr Tydfil","W06000024","Total",58802,28791,30011,58334,468,474,11139.29,5.3
"2011","Merthyr Tydfil","W06000024","Urban (total)",51525,25175,26350,51059,466,424,6464.62,8.0
"2011","Merthyr Tydfil","W06000024","Urban major conurbation",0,0,0,0,0,0,0.00,
"2011","Merthyr Tydfil","W06000024","Urban minor conurbation",0,0,0,0,0,0,0.00,
"2011","Merthyr Tydfil","W06000024","Urban city and town",51525,25175,26350,51059,466,424,6464.62,8.0
"2011","Merthyr Tydfil","W06000024","Urban city and town in a sparse setting",0,0,0,0,0,0,0.00,
"2011","Merthyr Tydfil","W06000024","Rural (total)",7277,3616,3661,7275,2,50,4674.67,1.6
"2011","Merthyr Tydfil","W06000024","Rural town and fringe",6472,3210,3262,6472,0,39,1905.66,3.4
"2011","Merthyr Tydfil","W06000024","Rural town and fringe in a sparse setting",0,0,0,0,0,0,0.00,
"2011","Merthyr Tydfil","W06000024","Rural village",576,299,277,574,2,7,766.05,0.8
"2011","Merthyr Tydfil","W06000024","Rural village in a sparse setting",0,0,0,0,0,0,0.00,
"2011","Merthyr Tydfil","W06000024","Rural hamlet and isolated dwellings",229,107,122,229,0,4,2002.96,0.1
"2011","Merthyr Tydfil","W06000024","Rural hamlet and isolated dwellings in a sparse setting",0,0,0,0,0,0,0.00,
"2011","Caerphilly","W06000018","Total",178806,87701,91105,177755,1051,1436,27745.02,6.4
"2011","Caerphilly","W06000018","Urban (total)",140467,68799,71668,139616,851,1114,14197.25,9.9
"2011","Caerphilly","W06000018","Urban major conurbation",0,0,0,0,0,0,0.00,
"2011","Caerphilly","W06000018","Urban minor conurbation",0,0,0,0,0,0,0.00,
"2011","Caerphilly","W06000018","Urban city and town",140467,68799,71668,139616,851,1114,14197.25,9.9
"2011","Caerphilly","W06000018","Urban city and town in a sparse setting",0,0,0,0,0,0,0.00,
"2011","Caerphilly","W06000018","Rural (total)",38339,18902,19437,38139,200,322,13547.77,2.8
"2011","Caerphilly","W06000018","Rural town and fringe",31118,15301,15817,30958,160,232,4934.14,6.3
"2011","Caerphilly","W06000018","Rural town and fringe in a sparse setting",0,0,0,0,0,0,0.00,
"2011","Caerphilly","W06000018","Rural village",6125,3054,3071,6085,40,71,6182.29,1.0
"2011","Caerphilly","W06000018","Rural village in a sparse setting",0,0,0,0,0,0,0.00,
"2011","Caerphilly","W06000018","Rural hamlet and isolated dwellings",1096,547,549,1096,0,19,2431.34,0.5
"2011","Caerphilly","W06000018","Rural hamlet and isolated dwellings in a sparse setting",0,0,0,0,0,0,0.00,
"2011","Blaenau Gwent","W06000019","Total",69814,34325,35489,69239,575,521,10876.16,6.4
"2011","Blaenau Gwent","W06000019","Urban (total)",60413,29588,30825,59864,549,451,6991.06,8.6
"2011","Blaenau Gwent","W06000019","Urban major conurbation",0,0,0,0,0,0,0.00,
"2011","Blaenau Gwent","W06000019","Urban minor conurbation",0,0,0,0,0,0,0.00,
"2011","Blaenau Gwent","W06000019","Urban city and town",60413,29588,30825,59864,549,451,6991.06,8.6
"2011","Blaenau Gwent","W06000019","Urban city and town in a sparse setting",0,0,0,0,0,0,0.00,
"2011","Blaenau Gwent","W06000019","Rural (total)",9401,4737,4664,9375,26,70,3885.10,2.4
"2011","Blaenau Gwent","W06000019","Rural town and fringe",7240,3653,3587,7234,6,48,1630.83,4.4
"2011","Blaenau Gwent","W06000019","Rural town and fringe in a sparse setting",0,0,0,0,0,0,0.00,
"2011","Blaenau Gwent","W06000019","Rural village",1212,598,614,1212,0,12,1360.01,0.9
"2011","Blaenau Gwent","W06000019","Rural village in a sparse setting",0,0,0,0,0,0,0.00,
"2011","Blaenau Gwent","W06000019","Rural hamlet and isolated dwellings",949,486,463,929,20,10,894.26,1.1
"2011","Blaenau Gwent","W06000019","Rural hamlet and isolated dwellings in a sparse setting",0,0,0,0,0,0,0.00,
"2011","Torfaen","W06000020","Total",91075,44382,46693,90360,715,792,12564.08,7.2
"2011","Torfaen","W06000020","Urban (total)",82822,40333,42489,82136,686,707,7322.46,11.3
"2011","Torfaen","W06000020","Urban major conurbation",0,0,0,0,0,0,0.00,
"2011","Torfaen","W06000020","Urban minor conurbation",0,0,0,0,0,0,0.00,
"2011","Torfaen","W06000020","Urban city and town",82822,40333,42489,82136,686,707,7322.46,11.3
"2011","Torfaen","W06000020","Urban city and town in a sparse setting",0,0,0,0,0,0,0.00,
"2011","Torfaen","W06000020","Rural (total)",8253,4049,4204,8224,29,85,5241.62,1.6
"2011","Torfaen","W06000020","Rural town and fringe",6960,3428,3532,6931,29,68,944.84,7.4
"2011","Torfaen","W06000020","Rural town and fringe in a sparse setting",0,0,0,0,0,0,0.00,
"2011","Torfaen","W06000020","Rural village",577,275,302,577,0,3,1181.51,0.5
"2011","Torfaen","W06000020","Rural village in a sparse setting",0,0,0,0,0,0,0.00,
"2011","Torfaen","W06000020","Rural hamlet and isolated dwellings",716,346,370,716,0,14,3115.27,0.2
"2011","Torfaen","W06000020","Rural hamlet and isolated dwellings in a sparse setting",0,0,0,0,0,0,0.00,
"2011","Monmouthshire","W06000021","Total",91323,44922,46401,89694,1629,1682,84914.94,1.1
"2011","Monmouthshire","W06000021","Urban (total)",48311,23404,24907,47566,745,761,5648.57,8.6
"2011","Monmouthshire","W06000021","Urban major conurbation",0,0,0,0,0,0,0.00,
"2011","Monmouthshire","W06000021","Urban minor conurbation",0,0,0,0,0,0,0.00,
"2011","Monmouthshire","W06000021","Urban city and town",48311,23404,24907,47566,745,761,5648.57,8.6
"2011","Monmouthshire","W06000021","Urban city and town in a sparse setting",0,0,0,0,0,0,0.00,
"2011","Monmouthshire","W06000021","Rural (total)",43012,21518,21494,42128,884,921,79266.37,0.5
"2011","Monmouthshire","W06000021","Rural town and fringe",16765,8366,8399,16259,506,256,3326.02,5.0
"2011","Monmouthshire","W06000021","Rural town and fringe in a sparse setting",0,0,0,0,0,0,0.00,
"2011","Monmouthshire","W06000021","Rural village",10704,5337,5367,10576,128,277,12675.14,0.8
"2011","Monmouthshire","W06000021","Rural village in a sparse setting",0,0,0,0,0,0,0.00,
"2011","Monmouthshire","W06000021","Rural hamlet and isolated dwellings",15543,7815,7728,15293,250,388,63265.21,0.2
"2011","Monmouthshire","W06000021","Rural hamlet and isolated dwellings in a sparse setting",0,0,0,0,0,0,0.00,
"2011","Newport","W06000022","Total",145736,71380,74356,144103,1633,1509,19051.60,7.6
"2011","Newport","W06000022","Urban (total)",128060,62747,65313,126620,1440,1191,6935.08,18.5
"2011","Newport","W06000022","Urban major conurbation",0,0,0,0,0,0,0.00,
"2011","Newport","W06000022","Urban minor conurbation",0,0,0,0,0,0,0.00,
"2011","Newport","W06000022","Urban city and town",128060,62747,65313,126620,1440,1191,6935.08,18.5
"2011","Newport","W06000022","Urban city and town in a sparse setting",0,0,0,0,0,0,0.00,
"2011","Newport","W06000022","Rural (total)",17676,8633,9043,17483,193,318,12116.52,1.5
"2011","Newport","W06000022","Rural town and fringe",12547,6083,6464,12376,171,223,1788.89,7.0
"2011","Newport","W06000022","Rural town and fringe in a sparse setting",0,0,0,0,0,0,0.00,
"2011","Newport","W06000022","Rural village",3981,1970,2011,3959,22,72,7066.67,0.6
"2011","Newport","W06000022","Rural village in a sparse setting",0,0,0,0,0,0,0.00,
"2011","Newport","W06000022","Rural hamlet and isolated dwellings",1148,580,568,1148,0,23,3260.96,0.4
"2011","Newport","W06000022","Rural hamlet and isolated dwellings in a sparse setting",0,0,0,0,0,0,0.00,

